abu dabi	አቡ ዳቢ
abud͡ʒa	አቡጃ
afɡanistan	አፍጋኒስታን
ail of man	አይል ኦፍ ማን
aisland	አይስላንድ
aiərland	አየርላንድ
akra	አክራ
albania	አልባኒያ
ald͡ʒeria	አልጄሪያ
ald͡ʒərs	አልጀርስ
aman	አማን
amstərdam	አምስተርዳም
andora	አንዶራ
andora la vela	አንዶራ ላ ቬላ
ankara	አንካራ
antananarivo	አንታናናሪቮ
antarktika	አንታርክቲካ
antiɡwa ʔɨna baruda	አንቲጓ እና ባሩዳ
apia	አፒያ
ard͡ʒəntina	አርጀንቲና
armenia	አርሜኒያ
aruba	አሩባ
asenʃn dəset	አሴንሽን ደሴት
astana	አስታና
asunsijon	አሱንሲዮን
atena	አቴና
australja	አውስትራልያ
azərbad͡ʒan	አዘርባጃን
aŋɡuʔila	አንጉኢላ
aŋɡwəla	አንጐላ
aʃɡabat	አሽጋባት
bahamas	ባሃማስ
bahren	ባህሬን
baku	ባኩ
bamako	ባማኮ
bandar səri beɡawan	ባንዳር ሰሪ ቤጋዋን
band͡ʒul	ባንጁል
barbedos	ባርቤዶስ
barselona	ባርሴሎና
basːterː	ባስቴር
bazɨl	ባዝል
baŋi	ባንጊ
baŋkok	ባንግኮክ
baŋɡladeʃ	ባንግላዴሽ
baɡdad	ባግዳድ
beid͡ʒiŋ	ቤዪጂንግ
bejrut	ቤይሩት
belarus	ቤላሩስ
beld͡ʒem	ቤልጄም
belizə	ቤሊዘ
belmopan	ቤልሞፓን
benin	ቤኒን
bermuda	ቤርሙዳ
bern	ቤርን
bisːau	ቢሳው
biʃkek	ቢሽኬክ
bogota	ቦጎታ
bolivia	ቦሊቪያ
bosnia ʔɨna herzoɡovinia	ቦስኒያ እና ሄርዞጎቪኒያ
botsɨwana	ቦትስዋና
bratislava	ብራቲስላቫ
brazavil	ብራዛቪል
brazil	ብራዚል
brazilia	ብራዚሊያ
bruksel	ብሩክሴል
bruni	ብሩኒ
brɨd͡ʒtaun	ብርጅታውን
budapest	ቡዳፔስት
bud͡ʒumbura	ቡጁምቡራ
buenos aires	ብዌኖስ አይሬስ
bukarəst	ቡካረስት
bulɡeria	ቡልጌሪያ
burkina faso	ቡርኪና ፋሶ
burundi	ቡሩንዲ
butan	ቡታን
buvet dəset	ቡቬት ደሴት
bəlgrad	በልግራድ
bərlin	በርሊን
bərma	በርማ
daka	ዳካ
dakar	ዳካር
denmark	ዴንማርክ
dijeɡo ɡarʃia	ዲዬጎ ጋርሺያ
dodoma	ዶዶማ
doha	ዶሃ
dominik ripublik	ዶሚኒክ ሪፑብሊክ
dominika	ዶሚኒካ
duʃanbe	ዱሻንቤ
dəblin	ደብሊን
dəbub afrika	ደቡብ አፍሪካ
dəbub d͡ʒord͡ʒia ʔɨna jədəbub sandwit͡ʃ dəsetot͡ʃ	ደቡብ ጆርጂያ እና የደቡብ ሳንድዊች ደሴቶች
dəbub koria	ደቡብ ኮሪያ
dəbub sudan	ደቡብ ሱዳን
dəbub tarawa	ደቡብ ታራዋ
dəmaskʼo	ደማስቆ
dəvanɨɡari	ደቫንጋሪ
d͡ʒakarta	ጃካርታ
d͡ʒamaika	ጃማይካ
d͡ʒapan	ጃፓን
d͡ʒibraltər	ጂብራልተር
d͡ʒibuti	ጂቡቲ
d͡ʒordan	ጆርዳን
d͡ʒord͡ʒia	ጆርጂያ
d͡ʒord͡ʒtaun	ጆርጅታውን
d͡ʒərmən	ጀርመን
d͡ʒərsi	ጀርሲ
el salvador	ኤል ሳልቫዶር
erɨtra	ኤርትራ
estonia	ኤስቶኒያ
fadut͡s	ፋዱጽ
fid͡ʒi	ፊጂ
filipins	ፊሊፒንስ
finland	ፊንላንድ
friːtaun	ፍሪታውን
funafuti	ፉናፉቲ
fərənsai	ፈረንሳይ
helsinki	ሄልሲንኪ
honduras	ሆንዱራስ
honiara	ሆኒያራ
hoŋ koŋ	ሆንግ ኮንግ
həjɨti	ሀይቲ
hənoj	ሀኖይ
hərare	ሀራሬ
həvana	ሀቫና
həŋɡari	ሀንጋሪ
hɨnd	ህንድ
ikwador	ኢኳዶር
ikwatorial ɡini	ኢኳቶሪያል ጊኒ
indoneʒia	ኢንዶኔዢያ
irakʼ	ኢራቅ
iran	ኢራን
islamabad	ኢስላማባድ
itjopʼja	ኢትዮጵያ
jamusukro	ያሙሱክሮ
jawunde	ያዉንዴ
jerevan	ዬሬቫን
jukren	ዩክሬን
junaitɨd stets	ዩናይትድ ስቴትስ
juɡanda	ዩጋንዳ
jəaland dəsetot͡ʃ	የአላንድ ደሴቶች
jəamerika samoa	የአሜሪካ ሳሞአ
jəamerika vərd͡ʒin dəsetot͡ʃ	የአሜሪካ ቨርጂን ደሴቶች
jəawropa hɨbɨrət	የአውሮፓ ህብረት
jəfaro dəsetot͡ʃ	የፋሮ ደሴቶች
jəfokland dəsetot͡ʃ	የፎክላንድ ደሴቶች
jəfərənsai polineʒia	የፈረንሳይ ፖሊኔዢያ
jəfərənsai ɡujana	የፈረንሳይ ጉያና
jəkanari dəsetot͡ʃ	የካናሪ ደሴቶች
jəkaribian nezərlands	የካሪቢያን ኔዘርላንድስ
jəməkakələɲaw afrika ripəblik	የመካከለኛው አፍሪካ ሪፐብሊክ
jəmən	የመን
jəsəmenawi mariana dəsetot͡ʃ	የሰሜናዊ ማሪያና ደሴቶች
jəɡəna dəset	የገና ደሴት
kabul	ካቡል
kaiman dəsetot͡ʃ	ካይማን ደሴቶች
kairo	ካይሮ
kambodia	ካምቦዲያ
kamerun	ካሜሩን
kampala	ካምፓላ
kanada	ካናዳ
kanbəra	ካንበራ
karakas	ካራካስ
kartum	ካርቱም
kastris	ካስትሪስ
katmandu	ካትማንዱ
kazakstan	ካዛክስታን
kazakɲa	ካዛክኛ
kenja	ኬንያ
kep verde	ኬፕ ቬርዴ
kijəv	ኪየቭ
kinʃasa	ኪንሻሳ
kiribati	ኪሪባቲ
kirɡistan	ኪርጊስታን
kito	ኪቶ
kiŋstaun	ኪንግስታውን
kiŋstən	ኪንግስተን
kiɡali	ኪጋሊ
kiʃinwɨ	ኪሺንው
klipərton dəset	ክሊፐርቶን ደሴት
kokos dəsetot͡ʃ	ኮኮስ ደሴቶች
kolombia	ኮሎምቢያ
komoros	ኮሞሮስ
kopənhəɡən	ኮፐንሀገን
kosovo	ኮሶቮ
kosta rika	ኮስታ ሪካ
koːt divwar	ኮት ዲቯር
koŋɡo brazavil	ኮንጎ ብራዛቪል
koŋɡo kinʃasa	ኮንጎ ኪንሻሳ
kroeʃja	ክሮኤሽያ
kuala lumpur	ኩዋላ ሉምፑር
kuba	ኩባ
kuk dəsetot͡ʃ	ኩክ ደሴቶች
kurasawo	ኩራሳዎ
kuweːt	ኩዌት
kwatar	ኳታር
kɨweːt	ክዌት
kʼɨdus bərtelome	ቅዱስ በርቴሎሜ
kʼɨdus pijer ʔɨna mikuʔelon	ቅዱስ ፒዬር እና ሚኩኤሎን
kʼɨdus vinsent ʔɨna ɡrenadins	ቅዱስ ቪንሴንት እና ግሬናዲንስ
laiberia	ላይቤሪያ
laos	ላኦስ
lapaz	ላፓዝ
latvia	ላትቪያ
lefkozia	ሌፍኮዚያ
lesoto	ሌሶቶ
libanos	ሊባኖስ
libia	ሊቢያ
librəvil	ሊብረቪል
liktənstain	ሊክተንስታይን
liloŋwe	ሊሎንጔ
lima	ሊማ
lituenia	ሊቱዌኒያ
lizbon	ሊዝቦን
ljubljana	ልዩብልያና
lome	ሎሜ
lu.is	ሉኢስ
luis	ሉዊስ
luksəmbərɡ	ሉክሰምበርግ
lusaka	ሉሳካ
lwanda	ሏንዳ
ləndən	ለንደን
madaɡaskar	ማዳጋስካር
madrid	ማድሪድ
mad͡ʒuro	ማጁሮ
malabo	ማላቦ
malajalm	ማላያልም
malawi	ማላዊ
maldivs	ማልዲቭስ
maleʒia	ማሌዢያ
mali	ማሊ
malta	ማልታ
managwa	ማናጓ
manama	ማናማ
manila	ማኒላ
mant͡ʃɨstər	ማንችስተር
maputo	ማፑቶ
martinik	ማርቲኒክ
marʃal ailand	ማርሻል አይላንድ
mbabane	ምባባኔ
mej.ote	ሜይኦቴ
meksiko	ሜክሲኮ
meksiko	ሜክሲኮ
mikroneʒia	ሚክሮኔዢያ
milano	ሚላኖ
minsk	ሚንስክ
mjənma	ምየንማ
mokʼadiʃo	ሞቃዲሾ
moldova	ሞልዶቫ
monako	ሞናኮ
monako	ሞናኮ
monrovia	ሞንሮቪያ
montevideo	ሞንቴቪዴዎ
montserat	ሞንትሴራት
montəneɡro	ሞንተኔግሮ
moritenia	ሞሪቴኒያ
moriʃəs	ሞሪሸስ
moroko	ሞሮኮ
moroni	ሞሮኒ
mosko	ሞስኮ
mozambik	ሞዛምቢክ
moŋɡolia	ሞንጎሊያ
məkʼedonja	መቄዶንያ
məseru	መሴሩ
məskət	መስከት
mɨʕɨrabawi sahra	ምዕራባዊ ሳህራ
na.uru	ናኡሩ
naid͡ʒeria	ናይጄሪያ
nairobi	ናይሮቢ
namibia	ናሚቢያ
nasːoː	ናሶ
nd͡ʒaməna	ንጃመና
nepal	ኔፓል
nezərland	ኔዘርላንድ
ni.uj	ኒኡይ
niame	ኒያሜ
nid͡ʒər	ኒጀር
nikaraɡwa	ኒካራጓ
niu deːli	ኒው ዴሊ
niu kaledonia	ኒው ካሌዶኒያ
niu ziːland	ኒው ዚላንድ
norfolk dəset	ኖርፎልክ ደሴት
norwej	ኖርዌይ
nukuʔəlofa	ኑኩአሎፋ
nuwakʃot	ኑዋክሾት
oman	ኦማን
oslo	ኦስሎ
ostria	ኦስትሪያ
otːawa	ኦታዋ
pakistan	ፓኪስታን
palau	ፓላው
palikir	ፓሊኪር
panama	ፓናማ
panama	ፓናማ
papuwa niu ɡini	ፓፑዋ ኒው ጊኒ
paramaribo	ፓራማሪቦ
paraɡwai	ፓራጓይ
paris	ፓሪስ
peru	ፔሩ
pitka.irn	ፒትካኢርን
pjoŋjaŋ	ፕዮንግያንግ
pnom pen	ፕኖም ፔን
podɡorit͡sa	ፖድጎሪጻ
poland	ፖላንድ
port luis	ፖርት ሉዊስ
port morsbi	ፖርት ሞርስቢ
port of speːn	ፖርት ኦፍ ስፔን
port vila	ፖርት ቪላ
porta riko	ፖርታ ሪኮ
porto novo	ፖርቶ ኖቮ
portoprins	ፖርቶፕሪንስ
portuɡal	ፖርቱጋል
praia	ፕራያ
praja	ፕራያ
praɡ	ፕራግ
pritoria	ፕሪቶሪያ
rabat	ራባት
raʃja	ራሽያ
rejkiavik	ሬይኪያቪክ
riad	ሪያድ
riga	ሪጋ
rijuniən	ሪዩኒየን
roma	ሮማ
romenia	ሮሜኒያ
rozoː	ሮዞ
ruanda	ሩዋንዳ
saiprəs	ሳይፕረስ
samo.ə	ሳሞአ
san hoze	ሳን ሆዜ
san marino	ሳን ማሪኖ
san marino	ሳን ማሪኖ
san salvador	ሳን ሳልቫዶር
san tome	ሳን ቶሜ
sana	ሳና
santiago	ሳንቲያጎ
santo domingo	ሳንቶ ዶሚንጎ
sarajevo	ሳራዬቮ
saudɨarəbia	ሳውድአረቢያ
sa.o tome ʔɨna prinsipe	ሳኦ ቶሜ እና ፕሪንሲፔ
seneɡal	ሴኔጋል
sent d͡ʒons	ሴንት ጆንስ
sent heləna	ሴንት ሄለና
sent lut͡ʃia	ሴንት ሉቺያ
sent martin	ሴንት ማርቲን
seralijon	ሴራሊዮን
se.utana melila	ሴኡታና ሜሊላ
sint martən	ሲንት ማርተን
siria	ሲሪያ
siŋɡapor	ሲንጋፖር
siʃels	ሲሼልስ
skopje	ስኮፕዬ
slovakia	ስሎቫኪያ
slovenia	ስሎቬኒያ
sofia	ሶፊያ
soːl	ሶል
speːn	ስፔን
stokolm	ስቶኮልም
suaziland	ሱዋዚላንድ
sudan	ሱዳን
sumale	ሱማሌ
surinam	ሱሪናም
suva	ሱቫ
svalbard ʔɨna d͡ʒan majən	ስቫልባርድ እና ጃን ማየን
swidɨn	ስዊድን
swizərland	ስዊዘርላንድ
səlomon dəset	ሰሎሞን ደሴት
səmen koria	ሰሜን ኮሪያ
sərbia	ሰርቢያ
tad͡ʒakistan	ታጃኪስታን
tai	ታይ
tailand	ታይላንድ
taipeː	ታይፔ
taiwan	ታይዋን
talin	ታሊን
tanzania	ታንዛኒያ
taɡalog	ታጋሎግ
taʃkent	ታሽኬንት
tblisi	ትብሊሲ
tehran	ቴህራን
tems	ቴምስ
teɡusiɡalpa	ቴጉሲጋልፓ
tirana	ቲራና
tokio	ቶክዮ
tokɨlau	ቶክላው
torino	ቶሪኖ
toŋɡa	ቶንጋ
toɡwə	ቶጐ
trinadad ʔɨna tobeɡo	ትሪናዳድ እና ቶቤጎ
tripoli	ትሪፖሊ
tristan di kunha	ትሪስታን ዲ ኩንሃ
tunis	ቱኒስ
tunizia	ቱኒዚያ
turk	ቱርክ
turkmenistan	ቱርክሜኒስታን
tuvalu	ቱቫሉ
tʼalian	ጣሊያን
tʼimpʼu	ጢምጱ
t͡ʃad	ቻድ
t͡ʃaina	ቻይና
t͡ʃek ripublik	ቼክ ሪፑብሊክ
t͡ʃerokiː	ቼሮኪ
t͡ʃili	ቺሊ
ulaʕan baʕatar	ኡላዓን ባዓታር
uraɡwai	ኡራጓይ
uzbekistan	ኡዝቤኪስታን
valːetːa	ቫሌታ
vanu.ətu	ቫኑአቱ
vatikan kətəma	ቫቲካን ከተማ
venɨzuela	ቬንዙዌላ
vetnam	ቬትናም
vijənːa	ቪየና
viktoria	ቪክቶሪያ
vilnius	ቪልኒውስ
vjəntjen	ቭየንትዬን
walis ʔɨna futuna dəsetot͡ʃ	ዋሊስ እና ፉቱና ደሴቶች
warsow	ዋርሶው
waɡaduɡu	ዋጋዱጉ
waʃiŋtən	ዋሺንግተን
weliŋtən	ዌሊንግተን
windhuːk	ዊንድሁክ
zambia	ዛምቢያ
zaɡreb	ዛግሬብ
zimbabwe	ዚምባብዌ
zurik	ዙሪክ
ɡabon	ጋቦን
ɡabərone	ጋበሮኔ
ɡambia	ጋምቢያ
ɡana	ጋና
ɡini	ጊኒ
ɡini bisao	ጊኒ ቢሳኦ
ɡrenada	ግሬናዳ
ɡrik	ግሪክ
ɡrinland	ግሪንላንድ
ɡuam	ጉዋም
ɡuatimala	ጉዋቲማላ
ɡujana	ጉያና
ɡurnəsi	ጉርነሲ
ɡuwadəlup	ጉዋደሉፕ
ɡɨbɨsʼɨ	ግብጽ
ɨsrael	እስራኤል
ɨŋliz	እንግሊዝ
ʃri lanka	ሽሪ ላንካ
ʔjərusalem	እየሩሳሌም
ˈpɔdgɔˌriʦa	ፖድጎሪጻ
