ababuj	أفافوخ
abades	أفاذيس
abadia	أفاذيا
abadiano	أفاذيانو
abadin	أفاذين
abanades	أفاناذيس
abanilla	أفانيليا
abaran	أفاران
abegondo	أفيغوندو
abejar	أفيخار
abejuela	أفيخويلا
abengibra	أفينخيفرا
abenojar	أفينوخار
abiego	أفيغو
abla	أفلا
ablitas	أفليتاس
abrera	أفريرا
abrucena	أفروثينا
acebo	أثيفو
acedera	أثيذيرا
acehuche	أثيأتشي
aceuchal	أثيوتشال
acrijos	أكريخوس
adahuesca	أذاأيسكا
adamuz	أذاموث
adanero	أذانيرو
aday	أذاي
adeje	أذيخي
ademuz	أذيموث
ador	أذور
adra	أذرا
adradas	أذراذاس
adrados	أذراذوس
adzaneta	أذثانيتا
agaete	أغايتي
ager	أخير
agoncillo	أغونثيليو
agost	أغوست
agramon	أغرامون
agramunt	أغرامونت
agreda	أغريذا
agres	أغريس
agron	أغرون
aguadulce	أغواذولثي
aguamansa	أغوامانسا
aguaron	أغوارون
aguas	أغواس
aguaviva	أغوافيفا
agudo	أغوذو
agüera	أغويرا
agüero	أغويرو
aguila	أغيلا
aguilafuente	أغيلافوينتي
aguilas	أغيلاس
agüimes	أغويميس
agullana	أغوليانا
agulo	أغولو
ahigal	أإِغال
ahillones	أإِليونيس
aianis	أيانيس
aibar	أيفار
aiguamurcia	أيغوامورثيا
ainsa	أينسا
aizpun	أيثبون
ajamil	أخاميل
alaejos	ألايخوس
alagon	ألاغون
alajar	ألاخار
alajero	ألاخيرو
alameda	ألاميذا
alamedilla	ألاميذيليا
alamillo	ألاميليو
alaminos	ألامينوس
alange	ألانخي
alarcon	ألاركون
alarilla	ألاريليا
alaro	ألارو
alatoz	ألاتوث
alayor	ألايور
alba	ألفا
albacete	ألفاثيتي
albages	ألفاخيس
albaladejo	ألفالاذيخو
albalatillo	ألفالاتيليو
albana	ألفانا
albanchez	ألفانتشيث
albares	ألفاريس
albarracin	ألفاراثين
albatana	ألفاتانا
albatera	ألفاتيرا
albendea	ألفينديا
albendin	ألفيندين
albentosa	ألفينتوسا
alberique	ألفيريكي
alberite	ألفيريتي
albesa	ألفيسا
albinana	ألفينانا
albocacer	ألفوكاثير
alboloduy	ألفولوذوي
albolote	ألفولوتي
albondon	ألفوندون
alboraya	ألفورايا
alborea	ألفوريا
albox	ألفوكس
albudeite	ألفوذييتي
albujon	ألفوخون
albuñol	ألفونول
albuñuelas	ألفونويلاس
alcadozo	ألكاذوثو
alcaine	ألكايني
alcampel	ألكامبيل
alcanadre	ألكاناذري
alcanar	ألكانار
alcanices	ألكانيثيس
alcaniz	ألكانيث
alcantara	ألكانتارا
alcantarilla	ألكانتاريليا
alcantud	ألكانتوذ
alcaracejos	ألكاراثيخوس
alcaraz	ألكاراث
alcarras	ألكاراس
alcaucin	ألكاوثين
alcaudete	ألكاوذيتي
alcazaren	ألكاثارين
alceda	ألثيذا
alcira	ألثيرا
alcoba	ألكوفا
alcobendas	ألكوفينداس
alcocebre	ألكوثيفري
alcocer	ألكوثير
alcohujate	ألكوأخاتي
alcolea	ألكوليا
alcollarin	ألكوليارين
alconchel	ألكونتشيل
alconera	ألكونيرا
alcontar	ألكونتار
alcora	ألكورا
alcorisa	ألكوريسا
alcoroches	ألكوروتشيس
alcover	ألكوفير
alcoy	ألكوي
alcubierre	ألكوفيري
alcubillas	ألكوفيلياس
alcublas	ألكوفلاس
alcudia	ألكوذيا
alcuescar	ألكويسكار
alcuneza	ألكونيثا
aldaya	ألدايا
aldea	ألديا
aldeacentenera	ألدياثينتينيرا
aldealpozo	ألديالبوثو
aldeaquemada	ألدياكيماذا
aldearrodrigo	ألدياروذريغو
aldeavieja	ألديافيخا
aldehuela	ألديأيلا
aldeire	ألدييري
aldover	ألدوفير
aledo	أليذو
alegria	أليغريا
alerre	أليري
aleson	أليسون
alfacar	ألفاكار
alfaiz	ألفايث
alfajarin	ألفاخارين
alfambra	ألفامبرا
alfamen	ألفامين
alfara	ألفارا
alfaraz	ألفاراث
alfaro	ألفارو
alfarras	ألفاراس
alfoz	ألفوث
algaida	ألغايذا
algamitas	ألغاميتاس
algarinejo	ألغارينيخو
algarra	ألغارا
algarrobo	ألغاروفو
algatocin	ألغاتوثين
algeciras	ألخيثيراس
algemesi	ألخيميسي
algete	ألخيتي
alginet	ألخينيت
algodonales	ألغوذوناليس
algora	ألغورا
algria	ألغريا
alguaire	ألغوايري
alguazas	ألغواثاس
algueña	ألغينا
alia	أليا
aliaga	ألياغا
alicante	أليكانتي
aliseda	أليسيذا
aljaraque	ألخاراكي
aljibe	ألخيفي
aljorra	ألخورا
aljucen	ألخوثين
allariz	ألياريث
allepuz	أليبوث
aller	ألير
alles	أليس
allo	أليو
alloza	أليوثا
almacellas	ألماثيلياس
almachar	ألماتشار
almaciles	ألماثيليس
almaden	ألماذين
almadenejos	ألماذينيخوس
almadrones	ألماذرونيس
almagro	ألماغرو
almajano	ألماخانو
almaluez	ألمالويث
almansa	ألمانسا
almanza	ألمانثا
almaraz	ألماراث
almatret	ألماتريت
almazan	ألماثان
almazora	ألماثورا
almazul	ألماثول
almedina	ألميذينا
almedinilla	ألميذينيليا
almegijar	ألميخيخار
almeida	ألمييذا
almenar	ألمينار
almenara	ألمينارا
almendra	ألميندرا
almendral	ألميندرال
almendralejo	ألميندراليخو
almendricos	ألميندريكوس
almendros	ألميندروس
almeria	ألميريا
almogia	ألموخيا
almoguera	ألموغيرا
almohaja	ألموأخا
almoharin	ألموأرين
almonte	ألمونتي
almoradi	ألموراذي
almorox	ألموروكس
almudebar	ألموذيفار
almuñécar	ألمونيكار
almuniente	ألمونينتي
almuradiel	ألموراذيل
almusafes	ألموسافيس
alobras	ألوفراس
alocen	ألوثين
alora	ألورا
alos	ألوس
alosno	ألوسنو
alovera	ألوفيرا
alozaina	ألوثاينا
alp	ألب
alpandeire	ألباندييري
alpanseque	ألبانسيكي
alpedroches	ألبيذروتشيس
alpeñés	ألبينيس
alpens	ألبينس
alpera	ألبيرا
alperiz	ألبيريث
alpuente	ألبوينتي
alquezar	ألكيثار
alsasua	ألساسوا
altable	ألتافلي
altamira	ألتاميرا
altarejos	ألتاريخوس
altea	ألتيا
altorricon	ألتوريكون
altoteiro	ألتوتييرو
altura	ألتورا
alustante	ألوستانتي
alvires	ألفيريس
alzola	ألثولا
amaya	أمايا
amer	أمير
ames	أميس
ameyugo	أمييوغو
amezaga	أميثاغا
amieva	أميفا
amoeiro	أموييرو
amorebieta	أموريفيتا
amposta	أمبوستا
ampudia	أمبوذيا
ampuero	أمبويرو
ampurias	أمبورياس
amurrio	أموريو
amusco	أموسكو
aña	أنا
anchuras	أنتشوراس
ancin	أنثين
andalucia	أندالوثيا
andavias	أندافياس
andilla	أنديليا
andoain	أندواين
andorra	أندورا
andosilla	أندوسيليا
andraitx	أندرايتش
andujar	أندوخار
angles	أنغليس
anglesola	أنغليسولا
angüés	أنغويس
anguiano	أنغيانو
anguix	أنغيكس
aniñón	أنينون
anleo	أنليو
añon	أنون
añora	أنورا
anso	أنسو
antas	أنتاس
antequera	أنتيكيرا
antigüedad	أنتيغويذاذ
antonaña	أنتونانا
anzanigo	أنثانيغو
anzuola	أنثوولا
anzur	أنثور
apatamonasterio	أباتاموناستيريو
apellaniz	أبيليانيث
aquilue	أكيلوي
aracena	أراثينا
arafo	أرافو
aragon	أراغون
aragoncillo	أراغونثيليو
aranarache	أراناراتشي
aranaz	أراناث
arandillo	أرانديليو
aranjuez	أرانخويث
arano	أرانو
aranzazu	أرانثاثو
aranzuegue	أرانثويغي
arapiles	أرابيليس
aras	أراس
aravaca	أرافاكا
araya	أرايا
arbeca	أرفيكا
arbo	أرفو
arbos	أرفوس
arceniega	أرثينيغا
archena	أرتشينا
archilla	أرتشيليا
arcos	أركوس
arcusa	أركوسا
ardisa	أرذيسا
aren	أرين
arenas	أريناس
areo	أريو
ares	أريس
areta	أريتا
arevalillo	أريفاليليو
arevalo	أريفالو
arganda	أرغاندا
arganza	أرغانثا
arguedas	أرغيذاس
arguellite	أرغيليتي
arguineguin	أرغينيغين
arguis	أرغيس
arija	أريخا
arinaga	أريناغا
ariñez	أرينيث
ariño	أرينو
arive	أريفي
ariza	أريثا
arizala	أريثالا
arjona	أرخونا
arjonilla	أرخونيليا
arlanzon	أرلانثون
armuna	أرمونا
arnedillo	أرنيذيليو
arnedo	أرنيذو
arnes	أرنيس
arnoya	أرنويا
arnuero	أرنويرو
aroche	أروتشي
aroizu	أرويثو
arona	أرونا
arquillos	أركيليوس
arrabalde	أرافالدي
arrancacepas	أرانكاثيباس
arrazola	أراثولا
arrecife	أريثيفي
arredondo	أريذوندو
arriate	أرياتي
arrieta	أريتا
arrigorriaga	أريغورياغا
arriondas	أريونداس
arroba	أروفا
arroniz	أرونيث
arroyal	أرويال
arroyos	أرويوس
arta	أرتا
artajona	أرتاخونا
artana	أرتانا
artazu	أرتاثو
arteijo	أرتييخو
artenara	أرتينارا
artes	أرتيس
artieda	أرتيذا
arties	أرتيس
arucas	أروكاس
arure	أروري
arzúa	أرثوا
asco	أسكو
asin	أسين
asomadilla	أسوماذيليا
ason	أسون
aspariegos	أسباريغوس
aspe	أسبي
astillero	أستيليرو
astudillo	أستوذيليو
asturianos	أستوريانوس
asturias	أستورياس
atalaya	أتالايا
atalayasa	أتالاياسا
ataquines	أتاكينيس
atarfe	أتارفي
atauta	أتاوتا
atea	أتيا
ateca	أتيكا
atienza	أتينثا
atocha	أتوتشا
auñón	أونون
ausejo	أوسيخو
autol	أوتول
autoria	أوتوريا
aveinte	أفيينتي
avellanes	أفيليانيس
avila	أفيلا
aviles	أفيليس
avinyo	أفينيو
avinyonet	أفينيونيت
avion	أفيون
ayamonte	أيامونتي
ayedo	أيذو
ayllon	أيليون
ayna	أينا
ayora	أيورا
aytona	أيتونا
azagra	أثاغرا
azaila	أثايلا
azañón	أثانون
azanuy	أثانوي
azcoitia	أثكويتيا
aznalcazar	أثنالكاثار
aznalcollar	أثنالكوليار
azpeitia	أثبييتيا
azuaga	أثواغا
azuara	أثوارا
azuelo	أثويلو
babilafuente	بافيلافوينتي
bacares	باكاريس
badajoz	باذاخوث
badalona	باذالونا
badaran	باذاران
badenas	باذيناس
badolatosa	باذولاتوسا
badules	باذوليس
baena	باينا
baeza	بايثا
baga	باغا
baguena	باغينا
bagur	باغور
bahillo	باإِليو
bailen	بايلين
baillo	بايليو
bajamar	باخامار
balaguer	بالاغير
balazote	بالاثوتي
balces	بالثيس
balconete	بالكونيتي
baleira	بالييرا
balerma	باليرما
balimbra	باليمبرا
balira	باليرا
ballerias	باليرياس
ballestar	باليستار
ballesteros	باليستيروس
ballobar	باليوفار
balsareny	بالساريني
balsicas	بالسيكاس
baltanas	بالتاناس
baltar	بالتار
bañares	باناريس
bande	باندي
bañeras	بانيراس
bañobarez	بانوفاريث
bañolas	بانولاس
bañon	بانون
banyoles	بانيوليس
banyos	بانيوس
baracaldo	باراكالدو
barahona	باراأنا
barajas	باراخاس
baralla	باراليا
barambio	بارامبيو
barasoain	باراسواين
barbadanes	بارفاذانيس
barbadillo	بارفاذيليو
barbalimpia	بارفاليمبيا
barbastro	بارفاسترو
barca	باركا
barcarrota	باركاروتا
barcena	بارثينا
barcheta	بارتشيتا
barcience	بارثينثي
barcones	باركونيس
bareyo	بارييو
bargas	بارغاس
barjos	بارخوس
barqueros	باركيروس
barracas	باراكاس
barrachina	باراتشينا
barraco	باراكو
barrax	باراكس
barreiros	بارييروس
barriomartin	باريومارتين
barro	بارو
barruecopardo	بارويكوبارذو
barzana	بارثانا
basauri	باساوري
bascara	باسكارا
basella	باسيليا
batea	باتيا
baterno	باتيرنو
bayo	بايو
bayona	بايونا
baza	باثا
beade	باذي
beariz	باريث
beas	باس
becarrea	بكاريا
beceite	بثييتي
bechi	بتشي
bedar	بذار
bedmar	بذمار
begijar	بخيخار
begonte	بغونتي
beire	بيري
beires	بيريس
bejar	بخار
bejis	بخيس
belchite	بلتشيتي
belianes	بليانيس
belinchón	بلينتشون
bello	بليو
belltall	بليتالي
bellver	بليفير
bellvey	بليفيي
bellvis	بليفيس
belmez	بلميث
belmonte	بلمونتي
belmontejo	بلمونتيخو
belorado	بلوراذو
belver	بلفير
bembibre	بمبيفري
benabarre	بنافاري
benacazon	بناكاثون
benafigos	بنافيغوس
benagalbon	بناغالفون
benaguacil	بناغواثيل
benahadux	بناأذوكس
benahavis	بناأفيس
benajarafa	بناخارافا
benalauria	بنالاوريا
benamaurel	بناماوريل
benameji	بناميخي
benamocarra	بناموكارا
benaocaz	بناوكاث
benaojan	بناوخان
benarraba	بنارافا
benasal	بناسال
benasque	بناسكي
benatae	بناتاي
benavente	بنافينتي
benavides	بنافيذيس
benavites	بنافيتيس
benegiles	بنيخيليس
benejama	بنيخاما
benejuzar	بنيخوثار
benferri	بنفيري
beniarda	بنيارذا
beniarres	بنياريس
benicasim	بنيكاسيم
benichembla	بنيتشيمبلا
benifallet	بنيفاليت
benifallim	بنيفاليم
benifayo	بنيفايو
beniganim	بنيغانيم
benilloba	بنيليوفا
benimasot	بنيماسوت
beninar	بنينار
beniopa	بنيوبا
benisa	بنيسا
benisanet	بنيسانيت
beniseno	بنيسينو
benitachell	بنيتاتشيلي
benizalon	بنيثالون
benuza	بنوثا
benzu	بنثو
beranga	برانغا
berantevilla	برانتيفيليا
bercedo	برثيذو
bercero	برثيرو
berducedo	برذوثيذو
berdun	برذون
berga	برغا
bergasa	برغاسا
bergondo	برغوندو
bergüenda	برغويندا
berja	برخا
berlanga	برلانغا
bermeo	برميو
berriz	بريث
berrocal	بروكال
berzocana	برثوكانا
besalu	بسالو
besaya	بسايا
bescane	بسكاني
betancuria	بتانكوريا
betanzos	بتانثوس
betelu	بتيلو
betera	بتيرا
beteta	بتيتا
bezes	بثيس
biar	بيار
bibey	بيفيي
biel	بيل
bielsa	بيلسا
bienvenida	بينبينيذا
biescas	بيسكاس
bigastro	بيغاسترو
biguezal	بيغيثال
bimeda	بيميذا
bimenes	بيمينيس
binaced	بيناثيذ
binefar	بينيفار
binies	بينيس
binisalem	بينيساليم
binue	بينوي
biosca	بيوسكا
biota	بيوتا
biscarrues	بيسكارويس
biurrun	بيورون
bizberri	بيثفيري
blanca	بلانكا
blancas	بلانكاس
blancos	بلانكوس
blanes	بلانيس
blanquilla	بلانكيليا
blazques	بلاثكيس
blecua	بليكوا
blesa	بليسا
boada	بواذا
boadilla	بواذيليا
boal	بوال
bobadilla	بوفاذيليا
boboras	بوفوراس
bocairente	بوكايرينتي
boceguillas	بوثيغيلياس
bocigas	بوثيغاس
boecillo	بويثيليو
bogarra	بوغارا
bogarre	بوغاري
bohoyo	بوأيو
boimorto	بويمورتو
bojar	بوخار
bolaños	بولانوس
bolea	بوليا
boltaña	بولتانا
bonanza	بونانثا
boñar	بونار
bonares	بوناريس
boniches	بونيتشيس
bonilla	بونيليا
boqueijon	بوكييخون
bordon	بورذون
borines	بورينيس
borja	بورخا
bornoba	بورنوفا
bornos	بورنوس
borobia	بوروفيا
borox	بوروكس
borres	بوريس
borriol	بوريول
bosost	بوسوست
bot	بوت
botorrita	بوتوريتا
boveda	بوفيذا
brabatas	برافاتاس
brañosera	برانوسيرا
braojos	براوخوس
brea	بريا
breda	بريذا
brenes	برينيس
bretun	بريتون
brihuega	بريأيغا
briñas	بريناس
brion	بريون
briones	بريونيس
briviesca	بريفيسكا
bronchales	برونتشاليس
broto	بروتو
brozas	بروثاس
brunete	برونيتي
brunola	برونولا
buciegas	بوثيغاس
budia	بوذيا
buena	بوينا
buenavista	بوينافيستا
buendia	بوينديا
bueu	بويو
bufali	بوفالي
bugarra	بوغارا
buger	بوخير
buitre	بويتري
bujalance	بوخالانثي
bujan	بوخان
bujaraloz	بوخارالوث
bullas	بولياس
buñero	بونيرو
buniel	بونيل
buñol	بونول
buñola	بونولا
buñuel	بونويل
burbaguena	بورفاغينا
bures	بوريس
burgo	بورغو
burgohondo	بورغوأندو
burgos	بورغوس
burguete	بورغيتي
burgui	بورغي
burguillos	بورغيليوس
buron	بورون
burriana	بوريانا
burujon	بوروخون
busot	بوسوت
busquistar	بوسكيستار
cabana	كافانا
cabañaquinta	كافاناكينتا
cabañas	كافاناس
cabanes	كافانيس
cabanillas	كافانيلياس
cabe	كافي
cabezamesada	كافيثاميساذا
cabezarados	كافيثاراذوس
cabezo	كافيثو
cabolafuente	كافولافوينتي
cabra	كافرا
cabrales	كافراليس
cabranes	كافرانيس
cabreiros	كافرييروس
cabrillanes	كافريليانيس
cabrillas	كافريلياس
cacabelos	كاكافيلوس
caceres	كاثيريس
cachilla	كاتشيليا
cachorrilla	كاتشوريليا
cacin	كاثين
cadagua	كاذاغوا
cadaques	كاذاكيس
cadavedo	كاذافيذو
cadi	كاذي
cadiar	كاذيار
cadreita	كاذرييتا
cadrete	كاذريتي
cala	كالا
calaceite	كالاثييتي
calaf	كالاف
calafell	كالافيلي
calahorra	كالاأرا
calamocha	كالاموتشا
calamonte	كالامونتي
calañas	كالاناس
calanda	كالاندا
calasparra	كالاسبارا
calatanazor	كالاتاناثور
calatayud	كالاتايوذ
calatorao	كالاتوراو
calaveruela	كالافيرويلا
caldas	كالداس
calderina	كالديرينا
caleruega	كاليرويغا
caleta	كاليتا
calicasas	كاليكاساس
calig	كاليغ
callejas	كاليخاس
calonge	كالونخي
calpe	كالبي
caltojar	كالتوخار
calvia	كالفيا
calzadilla	كالثاذيليا
camaleno	كامالينو
camallera	كاماليرا
camarao	كاماراو
camarasa	كاماراسا
camarena	كامارينا
camarillas	كاماريلياس
camariñas	كاماريناس
camas	كاماس
cambados	كامباذوس
cambil	كامبيل
cambre	كامبري
cambrils	كامبريلس
caminomorisco	كامينوموريسكو
caminreal	كامينريال
campanario	كامباناريو
campanet	كامبانيت
campanillas	كامبانيلياس
campano	كامبانو
campaspero	كامباسبيرو
campdevanol	كامبذيفانول
campello	كامبيليو
campillo	كامبيليو
campillos	كامبيليوس
campisabalos	كامبيسافالوس
campomanes	كامبومانيس
camporredondo	كامبوريذوندو
camporrells	كامبوريليس
camporrobles	كامبوروفليس
campos	كامبوس
campotejar	كامبوتيخار
camprodor	كامبروذور
camprovin	كامبروفين
camunas	كاموناس
cañada	كاناذا
cañadajuncosa	كاناذاخونكوسا
canales	كاناليس
canals	كانالس
cañamares	كاناماريس
cañamero	كاناميرو
cañar	كانار
cañaveral	كانافيرال
cañaveras	كانافيراس
cancarix	كانكاريكس
cancienes	كانثينيس
candas	كانداس
candasnos	كانداسنوس
candelaria	كانديلاريا
candelario	كانديلاريو
candeleda	كانديليذا
candilichera	كانديليتشيرا
candin	كاندين
canedo	كانيذو
canena	كانينا
canero	كانيرو
canfranc	كانفرانك
cangas	كانغاس
caniles	كانيليس
canillas	كانيلياس
canizal	كانيثال
canizares	كانيثاريس
canizo	كانيثو
canjayar	كانخايار
cantalapiedra	كانتالابيذرا
cantalejo	كانتاليخو
cantalojas	كانتالوخاس
cantalpino	كانتالبينو
cantareros	كانتاريروس
cantavieja	كانتافيخا
canteras	كانتيراس
cantillana	كانتيليانا
cantoral	كانتورال
cantoria	كانتوريا
canyellas	كانيلياس
caparroso	كاباروسو
capdella	كابذيليا
capdepera	كابذيبيرا
capellades	كابيلياذيس
capilduy	كابيلدوي
capilla	كابيليا
carabaña	كارافانا
carabanchel	كارافانتشيل
caracuel	كاراكويل
caralps	كارالبس
caravaca	كارافاكا
carbajo	كارفاخو
carbia	كارفيا
carcaboso	كاركافوسو
carcabuey	كاركافويي
carcagente	كاركاخينتي
carcar	كاركار
carcastillo	كاركاستيليو
carcelen	كارثيلين
carchel	كارتشيل
carchelejo	كارتشيليخو
cardejon	كارذيخون
cardona	كارذونا
carenas	كاريناس
cariñena	كارينينا
cariño	كارينو
carlet	كارليت
carmena	كارمينا
carracedelo	كاراثيذيلو
carral	كارال
carranque	كارانكي
carranza	كارانثا
carrascalejo	كاراسكاليخو
carrascosa	كاراسكوسا
carratraca	كاراتراكا
carreña	كارينا
carril	كاريل
carrizal	كاريثال
carrizo	كاريثو
carrizosa	كاريثوسا
carrocera	كاروثيرا
carroo	كاروو
cartama	كارتاما
cartaya	كارتايا
cartelle	كارتيلي
carucedo	كاروثيذو
casalarreina	كاسالاريينا
casar	كاسار
casarabonela	كاسارافونيلا
casarejos	كاساريخوس
casares	كاساريس
casariche	كاساريتشي
casasimarro	كاساسيمارو
casatejada	كاساتيخاذا
casavieja	كاسافيخا
cascante	كاسكانتي
caseda	كاسيذا
caseras	كاسيراس
caserras	كاسيراس
casinos	كاسينوس
caso	كاسو
caspe	كاسبي
castala	كاستالا
castalla	كاستاليا
castanesa	كاستانيسا
castaño	كاستانو
castaras	كاستاراس
castejon	كاستيخون
castelflorite	كاستيلفلوريتي
castellanos	كاستيليانوس
castelldans	كاستيليدانس
castelldefels	كاستيليديفيلس
castellote	كاستيليوتي
castells	كاستيليس
castelltallat	كاستيليتاليات
castellvell	كاستيليفيلي
castelseras	كاستيلسيراس
castelvispal	كاستيلفيسبال
castielfabib	كاستيلفافيف
castildelgado	كاستيلديلغاذو
castiliscar	كاستيليسكار
castilla	كاستيليا
castillejar	كاستيليخار
castilmimbre	كاستيلميمبري
castilnuevo	كاستيلنويفو
castralvo	كاسترالفو
castril	كاستريل
castrillon	كاستريليون
castrocalion	كاستروكاليون
castrocontrigo	كاستروكونتريغو
castrodeza	كاستروذيثا
castrogeriz	كاستروخيريث
castrogonzalo	كاستروغونثالو
castromocho	كاستروموتشو
castromonte	كاسترومونتي
castromudarra	كاستروموذارا
castronuevo	كاسترونويفو
castronuño	كاسترونونو
castropodame	كاستروبوذامي
castropol	كاستروبول
castuera	كاستويرا
catadau	كاتاذاو
catarroja	كاتاروخا
cati	كاتي
catllal	كاتليال
catoira	كاتويرا
catoute	كاتووتي
catral	كاترال
caude	كاوذي
caudete	كاوذيتي
caudiel	كاوذيل
caurel	كاوريل
cavezon	كافيثون
cayon	كايون
cazalegas	كاثاليغاس
cea	ثا
ceadea	ثاذيا
ceanuri	ثانوري
cebanico	ثفانيكو
cebolla	ثفوليا
cebollar	ثفوليار
cebollera	ثفوليرا
cebreros	ثفريروس
cebron	ثفرون
ceclavin	ثكلافين
cecos	ثكوس
cedeira	ثذييرا
cedillo	ثذيليو
cedrillas	ثذريلياس
cee	ثي
cehegin	ثإِخين
ceinos	ثينوس
cejo	ثخو
celadas	ثلاذاس
celanova	ثلانوفا
cella	ثليا
celtiberia	ثلتيفيريا
cenia	ثنيا
cenicero	ثنيثيرو
cenicientos	ثنيثينتوس
cenizate	ثنيثاتي
cenlle	ثنلي
centellas	ثنتيلياس
centenillo	ثنتينيليو
centro	ثنترو
cepeda	ثبيذا
cerceda	ثرثيذا
cercedilla	ثرثيذيليا
cerda	ثرذا
cerdedo	ثرذيذو
cerdido	ثرذيذو
cerezo	ثريثو
cernegula	ثرنيغولا
cerollera	ثروليرا
cerralbo	ثرالفو
cervera	ثرفيرا
cespedossa	ثسبيذوسا
cestona	ثستونا
cesuras	ثسوراس
cetina	ثتينا
ceuti	ثوتي
chamartin	تشامارتين
chamberi	تشامبيري
chantada	تشانتاذا
chapineria	تشابينيريا
charches	تشارتشيس
chauchina	تشاوتشينا
chavaler	تشافالير
checa	تشكا
cheles	تشليس
chella	تشليا
chelva	تشلفا
chera	تشرا
chercos	تشركوس
chert	تشيرت
cherta	تشرتا
cheste	تشستي
chiclana	تشيكلانا
chilches	تشيلتشيس
chilizarrias	تشيليثارياس
chillon	تشيليون
chiloeches	تشيلويتشيس
chimerraes	تشيميرايس
chinchon	تشينتشون
chío	تشيو
chipiona	تشيبيونا
chiprana	تشيبرانا
chirivel	تشيريفيل
chiva	تشيفا
chodos	تشوذوس
chovar	تشوفار
chueca	تشويكا
chulilla	تشوليليا
chullo	تشوليو
ciadoncha	ثياذونتشا
cibea	ثيفيا
cidad	ثيذاذ
cidones	ثيذونيس
ciempozuelos	ثيمبوثويلوس
cieza	ثيثا
cifuentes	ثيفوينتيس
cigales	ثيغاليس
cigüenza	ثيغوينثا
cillamayor	ثيليامايور
cillas	ثيلياس
cilleros	ثيليروس
cimballa	ثيمباليا
cinctorres	ثينكتوريس
cintruenigo	ثينتروينيغو
cional	ثيونال
ciordia	ثيورذيا
ciperez	ثيبيريث
cirat	ثيرات
cirauqui	ثيراوكي
ciria	ثيريا
ciriza	ثيريثا
ciruelos	ثيرويلوس
cirugeda	ثيروخيذا
cisla	ثيسلا
cisneros	ثيسنيروس
cistierna	ثيستيرنا
ciudadela	ثيوذاذيلا
ciutadilla	ثيوتاذيليا
clariana	كلاريانا
coaña	كوانا
cobatillas	كوفاتيلياس
cobdar	كوفذار
cobeta	كوفيتا
cobreros	كوفريروس
coca	كوكا
cocentaina	كوثينتاينا
codeseda	كوذيسيذا
codos	كوذوس
cofete	كوفيتي
cogollos	كوغوليوس
cogolludo	كوغوليوذو
coín	كوين
coiros	كويروس
coles	كوليس
colgadizos	كولغاذيثوس
colindres	كوليندريس
collados	كولياذوس
collanzo	كوليانثو
colliga	كوليغا
colmenar	كولمينار
colmenarejo	كولميناريخو
colomera	كولوميرا
colunga	كولونغا
comares	كوماريس
combarros	كومباروس
comillas	كوميلياس
competa	كومبيتا
compostela	كومبوستيلا
concud	كونكوذ
conil	كونيل
conjo	كونخو
conques	كونكيس
conquista	كونكيستا
consuegra	كونسويغرا
contes	كونتيس
copons	كوبونس
corbaton	كورفاتون
corbelle	كورفيلي
corbera	كورفيرا
corchuela	كورتشويلا
corconte	كوركونتي
corcubion	كوركوفيون
cordoba	كورذوفا
cordova	كورذوفا
cordovin	كورذوفين
corella	كوريليا
coreses	كوريسيس
corgo	كورغو
coria	كوريا
coripe	كوريبي
coristanco	كوريستانكو
corme	كورمي
cornago	كورناغو
corpa	كوربا
corralejo	كوراليخو
corrales	كوراليس
corredoiras	كوريذويراس
corrubedo	كوروفيذو
cortegada	كورتيغاذا
cortegana	كورتيغانا
cortelazor	كورتيلاثور
cortes	كورتيس
corullon	كوروليون
corvera	كورفيرا
cosa	كوسا
coscurita	كوسكوريتا
coslada	كوسلاذا
cospeito	كوسبييتو
costitx	كوستيتش
cosvenda	كوسفيندا
cotiella	كوتيليا
cotillas	كوتيلياس
cotillo	كوتيليو
cotobad	كوتوفاذ
cousa	كووسا
covadonga	كوفاذونغا
covarrubias	كوفاروفياس
covas	كوفاس
covelo	كوفيلو
cox	كوكس
cozar	كوثار
creciente	كريثينتي
cremenes	كريمينيس
crespos	كريسبوس
cretas	كريتاس
crevillente	كريفيلينتي
cripan	كريبان
cristobal	كريستوفال
cruce	كروثي
cuadros	كواذروس
cualedro	كواليذرو
cuatretonda	كواتريتوندا
cubells	كوفيليس
cubla	كوفلا
cucutas	كوكوتاس
cudillero	كوذيليرو
cuellar	كويليار
cuenca	كوينكا
culla	كوليا
cullera	كوليرا
culleredo	كوليريذو
cuntis	كونتيس
curueña	كوروينا
daimiel	دايميل
dalias	دالياس
dancharinea	دانتشارينيا
darnius	دارنيوس
daroca	داروكا
darrical	داريكال
darro	دارو
degaña	دغانا
deifontes	ديفونتيس
deleitosa	دلييتوسا
delicias	دليثياس
denia	دنيا
destriana	دستريانا
deusto	دوستو
deva	دفا
deya	ديا
deza	دثا
dicastillo	ديكاستيليو
diezma	ديثما
dilar	ديلار
dima	ديما
diustes	ديوستيس
dobro	دوفرو
dodro	دوذرو
dolar	دولار
dolores	دولوريس
domeno	دومينو
domingo	دومينغو
donado	دوناذو
dosbarrios	دوسفاريوس
dozon	دوثون
driebes	دريفيس
dueñas	دويناس
dumbria	دومبريا
durango	دورانغو
duraton	دوراتون
durcal	دوركال
ea	أا
echalar	أتشالار
echalecu	أتشاليكو
echano	أتشانو
echarri	أتشاري
ecija	أثيخا
egues	أغيس
eibar	أيفار
ejulve	أخولفي
elanchove	ألانتشوفي
elche	ألتشي
elda	ألدا
elgoibar	ألغويفار
elizondo	أليثوندو
eljas	ألخاس
elorrio	ألوريو
embid	أمبيذ
embun	أمبون
empanadas	أمباناذاس
encinas	أنثيناس
encinasola	أنثيناسولا
encinedo	أنثينيذو
encinillas	أنثينيلياس
enciso	أنثيسو
endrinal	أندرينال
enfesta	أنفيستا
enguera	أنغيرا
enguidanos	أنغيذانوس
enix	أنيكس
entrena	أنترينا
entrimo	أنتريمو
enveija	أنبييخا
epila	أبيلا
erice	أريثي
erillas	أريلياس
eriste	أريستي
erla	أرلا
ermua	أرموا
errazu	أراثو
erro	أرو
erustes	أروستيس
escairon	أسكايرون
escalada	أسكالاذا
escalante	أسكالانتي
escalo	أسكالو
escalona	أسكالونا
escalonilla	أسكالونيليا
escamilla	أسكاميليا
escanuela	أسكانويلا
escarroz	أسكاروث
escatron	أسكاترون
esclavitud	أسكلافيتوذ
escombreas	أسكومبرياس
escorca	أسكوركا
escoriaza	أسكورياثا
escorihuela	أسكوريأيلا
escriche	أسكريتشي
escucha	أسكوتشا
escullar	أسكوليار
escurial	أسكوريال
escusa	أسكوسا
escuzar	أسكوثار
esfiliana	أسفيليانا
esgos	أسغوس
espadan	أسباذان
espadaña	أسباذانا
espadañedo	أسباذانيذو
espadilla	أسباذيليا
esparragalejo	أسباراغاليخو
esparraguera	أسباراغيرا
espasante	أسباسانتي
espeja	أسبيخا
espejo	أسبيخو
espeluy	أسبيلوي
espera	أسبيرا
espes	أسبيس
espiel	أسبيل
espigüete	أسبيغويتي
espin	أسبين
espina	أسبينا
espinama	أسبيناما
espinilla	أسبينيليا
espirdo	أسبيرذو
esplegares	أسبليغاريس
esplugas	أسبلوغاس
esplus	أسبلوس
espolla	أسبوليا
espot	أسبوت
esquivias	أسكيفياس
establiments	أستافليمينتس
estadilla	أستاذيليا
estallo	أستاليو
estanyol	أستانيول
esteban	أستيفان
estella	أستيليا
estena	أستينا
estepa	أستيبا
estepar	أستيبار
estepona	أستيبونا
estivella	أستيفيليا
estopiñan	أستوبينان
estremera	أستريميرا
etreros	أتريروس
eulate	أولاتي
extremadura	أستريماذورا
ezcaray	أثكاراي
ezcurra	أثكورا
fabara	فافارا
fabero	فافيرو
facinas	فاثيناس
falces	فالثيس
falconera	فالكونيرا
falset	فالسيت
famorca	فاموركا
fañanas	فاناناس
fanlo	فانلو
farajan	فاراخان
farasdues	فاراسذويس
farena	فارينا
fariza	فاريثا
fatarella	فاتاريليا
faura	فاورا
favareta	فافاريتا
fayon	فايون
febro	ففرو
felanitx	فلانيتش
felechosa	فليتشوسا
felix	فليكس
fene	فني
feria	فريا
fermoselle	فرموسيلي
fernancaballero	فرنانكافاليرو
ferreira	فرييرا
ferrerias	فريرياس
ferreruela	فريرويلا
figols	فيغولس
figueras	فيغيراس
figueroles	فيغيروليس
figuerosa	فيغيروسا
finana	فينانا
finestrat	فينيسترات
finisterre	فينيستيري
fiscal	فيسكال
fitero	فيتيرو
flassa	فلاسا
flix	فليكس
fondon	فوندون
fonelas	فونيلاس
fonfria	فونفريا
fonollosa	فونوليوسا
fonsagrada	فونساغراذا
fontanar	فونتانار
fontanarejo	فونتاناريخو
fontanosas	فونتانوساس
fontao	فونتاو
fontellas	فونتيلياس
fontioso	فونتيوسو
fontiveros	فونتيفيروس
fontllonga	فونتليونغا
fonz	فونث
forcarey	فوركاريي
foronda	فوروندا
forua	فوروا
foz	فوث
frades	فراذيس
fraga	فراغا
frailes	فرايليس
francos	فرانكوس
frechilla	فريتشيليا
fredes	فريذيس
freginals	فريخينالس
freila	فرييلا
fresnedilla	فريسنيذيليا
fresnedo	فريسنيذو
frias	فرياس
frigiliana	فريخيليانا
friol	فريول
fromista	فروميستا
frumales	فروماليس
fuencaliente	فوينكالينتي
fuencarral	فوينكارال
fuencemillan	فوينثيميليان
fuendejalon	فوينديخالون
fuendetodos	فوينديتوذوس
fuenferrada	فوينفيراذا
fuengirola	فوينخيرولا
fuenlabrada	فوينلافراذا
fuenllana	فوينليانا
fuenmayor	فوينمايور
fuensalida	فوينساليذا
fuensanta	فوينسانتا
fuentealbilla	فوينتيالفيليا
fuenteboa	فوينتيفوا
fuentecen	فوينتيثين
fuenteguinaldo	فوينتيغينالدو
fuenteheridos	فوينتيإِريذوس
fuentelapeña	فوينتيلابينا
fuentelcesped	فوينتيلثيسبيذ
fuentelmonje	فوينتيلمونخي
fuentelsaz	فوينتيلساث
fuentemilanos	فوينتيميلانوس
fuentenovilla	فوينتينوفيليا
fuentepelayo	فوينتيبيلايو
fuentepinilla	فوينتيبينيليا
fuenterrabia	فوينتيرافيا
fuenterrebollo	فوينتيريفوليو
fuenterrobles	فوينتيروفليس
fuentes	فوينتيس
fuentesaúco	فوينتيساوكو
fuentescusa	فوينتيسكوسا
fuentesecas	فوينتيسيكاس
fuentespalda	فوينتيسبالدا
fuentespina	فوينتيسبينا
fuentidueña	فوينتيذوينا
funes	فونيس
furnas	فورناس
fustiñana	فوستينانا
gabaldon	غافالدون
gabarret	غافاريت
gabasa	غافاسا
gador	غاذور
gajanejos	غاخانيخوس
gajates	غاخاتيس
galapagar	غالاباغار
galapagos	غالاباغوس
galar	غالار
galaroza	غالاروثا
galbarra	غالفارا
galdacano	غالداكانو
galdames	غالداميس
galende	غاليندي
galera	غاليرا
galicia	غاليثيا
galinduste	غاليندوستي
galisteo	غاليستيو
gallegos	غاليغوس
gallinal	غالينال
gallur	غاليور
galvez	غالفيث
gamonal	غامونال
ganame	غانامي
gandesa	غانديسا
gandia	غانديا
ganuelas	غانويلاس
garaballa	غارافاليا
garayoa	غارايوا
garcillan	غارثيليان
gargaligas	غارغاليغاس
gargallo	غارغاليو
gargüera	غارغويرا
garinoain	غارينواين
garoiez	غارويث
garraf	غاراف
garralda	غارالدا
garray	غاراي
garrigas	غاريغاس
garrovillas	غاروفيلياس
garrucha	غاروتشا
gascueña	غاسكوينا
gata	غاتا
gatova	غاتوفا
gaucin	غاوثين
gauna	غاونا
gava	غافا
gavanes	غافانيس
gelida	خليذا
gelsa	خلسا
gelves	خلفيس
genalguacil	خنالغواثيل
genave	خنافي
genevilla	خنيفيليا
gerena	خرينا
germade	خرماذي
gerona	خرونا
gerri	خري
gesera	خسيرا
geve	خفي
gibarroyo	خيفارويو
gijon	خيخون
gilena	خيلينا
gimenells	خيمينيليس
gironella	خيرونيليا
godall	غوذالي
godelleta	غوذيليتا
goiriz	غويريث
goizueta	غويثويتا
golada	غولاذا
golpejas	غولبيخاس
gomara	غومارا
gomecello	غوميثيليو
gomesende	غوميسيندي
gondomar	غوندومار
gor	غور
gorafe	غورافي
gormaz	غورماث
gotarrendura	غوتاريندورا
gozon	غوثون
gradefes	غراذيفيس
grado	غراذو
grajera	غراخيرا
granada	غراناذا
granadella	غراناذيليا
granadilla	غراناذيليا
granatula	غراناتولا
grandes	غرانديس
grañén	غرانين
granollers	غرانوليرس
graus	غراوس
gravalos	غرافالوس
grazalema	غراثاليما
griegos	غريغوس
griñón	غرينون
grisen	غريسين
grove	غروفي
guadahortuna	غواذاأرتونا
guadajoz	غواذاخوث
guadalajara	غواذالاخارا
guadalaviar	غواذالافيار
guadalcanal	غواذالكانال
guadalcazar	غواذالكاثار
guadalupe	غواذالوبي
guadamur	غواذامور
guadarrama	غواذاراما
guadarranque	غواذارانكي
guadasuar	غواذاسوار
guadix	غواذيكس
gualchos	غوالتشوس
gualta	غوالتا
guardiola	غوارذيولا
guardo	غوارذو
guareña	غوارينا
guaro	غوارو
guarroman	غوارومان
gudar	غوذار
guecho	غتشو
güeñes	غوينيس
güesa	غويسا
guetaria	غتاريا
guiana	غيانا
guijo	غيخو
guijuelo	غيخويلو
guillarey	غيلياريي
guillena	غيلينا
guillerias	غيليرياس
guimaray	غيماراي
guimera	غيميرا
guisona	غيسونا
guitiriz	غيتيريث
gulina	غولينا
guntin	غونتين
guriezo	غوريثو
gurp	غورب
hacinas	أثيناس
haro	أرو
hecho	أتشو
helechal	أليتشال
helechosa	أليتشوسا
hellin	ألين
henarejos	أناريخوس
henche	أنتشي
herbes	أرفيس
herencia	أرينثيا
hernani	أرناني
hernansancho	أرنانسانتشو
herramelluri	أراميليوري
herrera	أريرا
herreria	أريريا
herrerias	أريرياس
herreros	أريروس
herreruela	أريرويلا
hervas	أرفاس
higa	إِغا
higuera	إِغيرا
higueruela	إِغيرويلا
higueruelas	إِغيرويلاس
hijar	إِخار
hinodejo	إِنوذيخو
hinojal	إِنوخال
hinojales	إِنوخاليس
hinojares	إِنوخاريس
hinojos	إِنوخوس
hinojosa	إِنوخوسا
hinojosas	إِنوخوساس
holguera	ألغيرا
hombrados	أمبراذوس
honrubia	أنروفيا
hontalbilla	أنتالفيليا
hontanares	أنتاناريس
hontanaya	أنتانايا
hontecillos	أنتيثيليوس
hontoba	أنتوفا
horche	أرتشي
hornos	أرنوس
hospitalet	أسبيتاليت
hoyos	أيوس
hoyuelos	أيويلوس
huarte	أارتي
huelago	أيلاغو
huelamo	أيلامو
huelma	أيلما
huelva	أيلفا
huelves	أيلفيس
hueneja	أينيخا
huermeces	أيرميثيس
huerrios	أيريوس
huertahernando	أيرتاإِرناندو
huerteles	أيرتيليس
huerto	أيرتو
huesa	أيسا
huesca	أيسكا
huescar	أيسكار
huete	أيتي
humanes	أمانيس
humilladero	أميلياذيرو
husillos	أسيليوس
ibahernando	إِفاإِرناندو
ibdes	إِفذيس
ibi	إِفي
iborra	إِفورا
ibros	إِفروس
idocin	إِذوثين
iglesias	إِغليسياس
igualada	إِغوالاذا
igualeja	إِغواليخا
igüeña	إِغوينا
ilche	إِلتشي
ilerda	إِليرذا
ilipa	إِليبا
illana	إِليانا
illano	إِليانو
illas	إِلياس
illescas	إِليسكاس
illora	إِليورا
illueca	إِليويكا
imon	إِمون
incinillas	إِنثينيلياس
incio	إِنثيو
infantes	إِنفانتيس
infiesto	إِنفيستو
iniesta	إِنيستا
instincion	إِنستينثيون
irijo	إِريخو
irijoa	إِريخوا
irueste	إِرويستي
irun	إِرون
irura	إِرورا
irurita	إِروريتا
irurozqui	إِروروثكي
isaba	إِسافا
iscar	إِسكار
isil	إِسيل
isona	إِسونا
isso	إِسو
istan	إِستان
isuerre	إِسويري
itrabo	إِترافو
ituero	إِتويرو
izalzu	إِثالثو
izarra	إِثارا
iznájar	إِثناخار
iznalloz	إِثناليوث
iznatoraf	إِثناتوراف
jabaga	خافاغا
jabalera	خافاليرا
jabaloyas	خافالوياس
jabalquinto	خافالكينتو
jabarriega	خافاريغا
jabugo	خافوغو
jaca	خاكا
jadraque	خاذراكي
jaen	خاين
jalance	خالانثي
jalon	خالون
jaraba	خارافا
jaraco	خاراكو
jarafuel	خارافويل
jaraicejo	خارايثيخو
jarandilla	خارانديليا
jaray	خاراي
jarque	خاركي
jatar	خاتار
jatiel	خاتيل
jativa	خاتيفا
jaulin	خاولين
jaurrieta	خاوريتا
javea	خافيا
jayena	خاينا
jemenuño	خمينونو
jeresa	خريسا
jerica	خريكا
jerte	خرتي
jimena	خيمينا
jirueque	خيرويكي
jodar	خوذار
jorairatar	خورايراتار
jorcas	خوركاس
jorquera	خوركيرا
jove	خوفي
jubera	خوفيرا
jubrique	خوفريكي
judes	خوذيس
judio	خوذيو
jumilla	خوميليا
juncajo	خونكاخو
juncosa	خونكوسا
juneda	خونيذا
labacolla	لافاكوليا
labajos	لافاخوس
laborcillas	لافورثيلياس
lacalahorra	لاكالاأرا
lachar	لاتشار
lacumbre	لاكومبري
lage	لاخي
laguarres	لاغواريس
laguarta	لاغوارتا
lagunaseca	لاغوناسيكا
lagunilla	لاغونيليا
lalin	لالين
lama	لاما
lanaja	لاناخا
lancara	لانكارا
lanciego	لانثيغو
landete	لانديتي
lanestosa	لانيستوسا
langreo	لانغريو
languilla	لانغيليا
lanjaron	لانخارون
lantadilla	لانتاذيليا
lanteira	لانتييرا
lanz	لانث
lanza	لانثا
lapeza	لابيثا
lardero	لارذيرو
laredo	لاريذو
laroco	لاروكو
laroles	لاروليس
larrainzar	لاراينثار
larraona	لاراونا
larrion	لاريون
lasarte	لاسارتي
latina	لاتينا
latre	لاتري
lavadores	لافاذوريس
lavapiés	لافابيس
layana	لايانا
layna	لاينا
layos	لايوس
laza	لاثا
leache	لياتشي
lebrija	ليفريخا
lecera	ليثيرا
leciñena	ليثينينا
lecumberri	ليكومبيري
ledaña	ليذانا
ledanca	ليذانكا
ledesma	ليذيسما
leganés	ليغانيس
leganiel	ليغانيل
leiro	لييرو
leitariegos	لييتاريغوس
leiza	لييثا
lemona	ليمونا
lences	لينثيس
lepe	ليبي
lequeitio	ليكييتيو
lerga	ليرغا
lerida	ليريذا
lerin	ليرين
lerma	ليرما
les	ليس
lesaca	ليساكا
letur	ليتور
letux	ليتوكس
leza	ليثا
lezama	ليثاما
lezuza	ليثوثا
librilla	ليفريليا
libros	ليفروس
lidon	ليذون
liédena	ليذينا
lietor	ليتور
lijar	ليخار
lillol	ليليول
limpias	ليمبياس
linares	ليناريس
liñola	لينولا
liria	ليريا
lizarraga	ليثاراغا
llado	لياذو
llafranc	ليافرانك
llagostera	لياغوستيرا
llanes	ليانيس
llansa	ليانسا
llauri	لياوري
llera	ليرا
llerena	ليرينا
llers	ليرس
lles	ليس
llivia	ليفيا
llobregales	ليوفريغاليس
llodio	ليوذيو
llombay	ليومباي
lloseta	ليوسيتا
llovera	ليوفيرا
llubi	ليوفي
lluchmayor	ليوتشمايور
loarre	لواري
lobatejo	لوفاتيخو
lobera	لوفيرا
lobon	لوفون
lodosa	لوذوسا
loeches	لويتشيس
logroño	لوغرونو
logrosan	لوغروسان
loja	لوخا
lombrana	لومبرانا
longares	لونغاريس
lopera	لوبيرا
lorca	لوركا
lorcha	لورتشا
lorenzana	لورينثانا
lores	لوريس
lorqui	لوركي
losacino	لوساثينو
lousame	لووسامي
lovios	لوفيوس
lozoya	لوثويا
lozoyuela	لوثويويلا
luanco	لوانكو
luarca	لواركا
lubian	لوفيان
lubrin	لوفرين
lucar	لوكار
lucena	لوثينا
luceni	لوثيني
lucillo	لوثيليو
ludiente	لوذينتي
luelmo	لويلمو
luesia	لويسيا
luezas	لويثاس
lugan	لوغان
lugo	لوغو
lugones	لوغونيس
lugros	لوغروس
lujar	لوخار
lumbier	لومبير
lumbrales	لومبراليس
lumbreras	لومبريراس
lumpiaque	لومبياكي
luna	لونا
luque	لوكي
luyego	لويغو
luzaga	لوثاغا
luzon	لوثون
macael	ماكايل
maceda	ماثيذا
machero	ماتشيرو
macotera	ماكوتيرا
maderuelo	ماذيرويلو
madridejos	ماذريذيخوس
madrigalejo	ماذريغاليخو
madriguera	ماذريغيرا
madrigueras	ماذريغيراس
madrona	ماذرونا
madronera	ماذرونيرا
madroño	ماذرونو
maella	مايليا
maello	مايليو
maestre	مايستري
maestu	مايستو
magacela	ماغاثيلا
magallon	ماغاليون
magaña	ماغانا
magaz	ماغاث
magina	ماخينا
maguilla	ماغيليا
mahide	ماإِذي
mahon	ماأن
mahora	ماأرا
mainar	ماينار
majadas	ماخاذاس
majaelrayo	ماخايلرايو
mala	مالا
malagon	مالاغون
malaguilla	مالاغيليا
malanquilla	مالانكيليا
malcocinado	مالكوثيناذو
malgrat	مالغرات
mallen	مالين
malon	مالون
malpica	مالبيكا
maluenda	مالويندا
mampodre	مامبوذري
manacor	ماناكور
manchita	مانتشيتا
mandayona	ماندايونا
mañeru	مانيرو
manilva	مانيلفا
manises	مانيسيس
manlleu	مانليو
manresa	مانريسا
manresana	مانريسانا
mansilla	مانسيليا
mantañes	مانتانيس
mantiel	مانتيل
manzanares	مانثاناريس
manzaneda	مانثانيذا
manzanedo	مانثانيذو
manzaneque	مانثانيكي
manzanera	مانثانيرا
maqueda	ماكيذا
maracena	ماراثينا
maranchon	مارانتشون
marazoleja	ماراثوليخا
marbella	مارفيليا
marcilla	مارثيليا
marganell	مارغانيلي
mariana	ماريانا
marin	مارين
marinaleda	ماريناليذا
marines	مارينيس
marmolejo	مارموليخو
marron	مارون
marrube	ماروفي
marrupe	ماروبي
martorell	مارتوريلي
martos	مارتوس
marugan	ماروغان
masa	ماسا
masalaves	ماسالافيس
masamagrell	ماساماغريلي
masanasa	ماساناسا
mascaraque	ماسكاراكي
masegoso	ماسيغوسو
maside	ماسيذي
masquefa	ماسكيفا
massanas	ماساناس
matabuena	ماتافوينا
matagalls	ماتاغاليس
matalebreras	ماتاليفريراس
matallana	ماتاليانا
matamorosa	ماتاموروسا
matanza	ماتانثا
matapozuelos	ماتابوثويلوس
mataro	ماتارو
matarrubia	ماتاروفيا
matedeon	ماتيذيون
matienzo	ماتينثو
matute	ماتوتي
mausoleo	ماوسوليو
mayalde	مايالدي
mayals	مايالس
mayorga	مايورغا
mazarete	ماثاريتي
mazaricos	ماثاريكوس
mazarron	ماثارون
mazarulleque	ماثاروليكي
mazateron	ماثاتيرون
mazuecos	ماثويكوس
meano	مانو
meco	مكو
mediana	مذيانا
medina	مذينا
mediña	مذينا
medinaceli	مذيناثيلي
mediodia	مذيوذيا
mediona	مذيونا
meijaboy	ميخافوي
meira	ميرا
meis	ميس
mejorada	مخوراذا
meliana	مليانا
melida	مليذا
mellid	مليذ
melon	ملون
membrilla	ممبريليا
membrillar	ممبريليار
membrillera	ممبريليرا
membrio	ممبريو
menasalbas	مناسالفاس
mencal	منكال
mendavia	مندافيا
mendigorria	منديغوريا
meneses	منيسيس
mengabril	منغافريل
mengibar	منخيفار
mentrida	منتريذا
mequinenza	مكينينثا
mera	مرا
merida	مريذا
mesia	مسيا
mesones	مسونيس
mestanza	مستانثا
miajadas	مياخاذاس
miedes	ميذيس
mieras	ميراس
mieres	ميريس
mieza	ميثا
miguelturra	ميغيلتورا
mijares	ميخاريس
mijas	ميخاس
milagro	ميلاغرو
millana	ميليانا
millares	ميلياريس
millena	ميلينا
minana	مينانا
minateda	ميناتيذا
minaya	مينايا
minglanilla	مينغلانيليا
mingorria	مينغوريا
miño	مينو
mira	ميرا
mirabel	ميرافيل
mirambel	ميرامبيل
mirandilla	ميرانديليا
miravalles	ميرافاليس
miravet	ميرافيت
miravete	ميرافيتي
moaña	موانا
mocejon	موثيخون
mochales	موتشاليس
moclin	موكلين
moeche	مويتشي
mofrecho	موفريتشو
mogente	موخينتي
mogon	موغون
moguer	موغير
mohedas	موإِذاس
mohorte	موأرتي
mojacar	موخاكار
mojados	موخاذوس
mojina	موخينا
mola	مولا
molaton	مولاتون
molinaseca	موليناسيكا
molinicos	مولينيكوس
molinos	مولينوس
molledo	موليذو
mollerusa	موليروسا
mollet	موليت
mollina	مولينا
mollo	موليو
moluengo	مولوينغو
molvizar	مولفيثار
mombeltran	مومبيلتران
mombuey	مومبويي
monachil	موناتشيل
monbeltran	مونبيلتران
moncada	مونكاذا
moncalvo	مونكالفو
moncayo	مونكايو
moncloa	مونكلوا
moncofar	مونكوفار
monda	موندا
mondariz	مونداريث
mondejar	مونديخار
mondoñedo	موندونيذو
mondragon	موندراغون
monduber	موندوفير
monegrillo	مونيغريليو
monesterio	مونيستيريو
moneva	مونيفا
monfero	مونفيرو
monflorite	مونفلوريتي
mongo	مونغو
monistrol	مونيسترول
monleras	مونليراس
monovar	مونوفار
monreal	مونريال
monroy	مونروي
monroyo	مونرويو
monsagro	مونساغرو
monserrat	مونسيرات
montalban	مونتالفان
montalbanejo	مونتالفانيخو
montalbo	مونتالفو
montalbos	مونتالفوس
montalvos	مونتالفوس
montan	مونتان
montanchez	مونتانتشيث
montanyola	مونتانيولا
montarto	مونتارتو
monteagudo	مونتياغوذو
montearagon	مونتياراغون
montederramo	مونتيذيرامو
montefrio	مونتيفريو
montejaque	مونتيخاكي
montejicar	مونتيخيكار
montellano	مونتيليانو
montemolin	مونتيمولين
monterrey	مونتيريي
monterroso	مونتيروسو
monterrubio	مونتيروفيو
montesa	مونتيسا
montesclaros	مونتيسكلاروس
montiel	مونتيل
montijo	مونتيخو
montilla	مونتيليا
montillana	مونتيليانا
montizon	مونتيثون
montmelo	مونتميلو
monton	مونتون
montoro	مونتورو
montras	مونتراس
montroy	مونتروي
montuenga	مونتوينغا
montuiri	مونتويري
monturque	مونتوركي
monzon	مونثون
mora	مورا
moral	مورال
moraleja	موراليخا
morales	موراليس
moralina	مورالينا
moraña	مورانا
morante	مورانتي
moratalla	موراتاليا
morcillo	مورثيليو
moreda	موريذا
morell	موريلي
morella	موريليا
morentin	مورينتين
mores	موريس
morey	موريي
moriles	موريليس
morillejo	موريليخو
morla	مورلا
moros	موروس
mos	موس
mosqueruela	موسكيرويلا
mostoles	موستوليس
motilla	موتيليا
motilleja	موتيليخا
motos	موتوس
motril	موتريل
moya	مويا
moyuela	مويويلا
mozoncillo	موثونثيليو
muchamiel	موتشاميل
mucientes	موثينتيس
muel	مويل
mugaire	موغايري
mugardos	موغارذوس
mugia	موخيا
mugica	موخيكا
muiños	موينوس
mula	مولا
muñana	مونانا
munebrega	مونيفريغا
munera	مونيرا
mungia	مونخيا
munico	مونيكو
muniesa	مونيسا
munilla	مونيليا
muñogalindo	مونوغاليندو
muñogrande	مونوغراندي
muntadas	مونتاذاس
muras	موراس
murchante	مورتشانتي
murcia	مورثيا
murguia	مورغيا
muriel	موريل
muro	مورو
muros	موروس
murtas	مورتاس
murueta	مورويتا
nacimiento	ناثيمينتو
nagore	ناغوري
naharros	ناأروس
najera	ناخيرا
nambroca	نامبروكا
naquera	ناكيرا
narboneta	نارفونيتا
naron	نارون
nava	نافا
navacerrada	نافاثيراذا
navachica	نافاتشيكا
navaconcejo	نافاكونثيخو
navafria	نافافريا
navahermosa	نافاإِرموسا
navahondilla	نافاأنديليا
navajas	نافاخاس
naval	نافال
navalacruz	نافالاكروث
navalagamella	نافالاغاميليا
navalcaballo	نافالكافاليو
navalcan	نافالكان
navaleno	نافالينو
navalguijo	نافالغيخو
navalilla	نافاليليا
navalmanzano	نافالمانثانو
navalmoral	نافالمورال
navalmoralejo	نافالموراليخو
navalonguilla	نافالونغيليا
navalosa	نافالوسا
navalpino	نافالبينو
navalsauz	نافالساوث
navaluenga	نافالوينغا
navardun	نافارذون
navarres	نافاريس
navarrete	نافاريتي
navas	نافاس
navasa	نافاسا
navascues	نافاسكويس
navasfrias	نافاسفرياس
navata	نافاتا
navelgas	نافيلغاس
naves	نافيس
navia	نافيا
nebreda	نفريذا
neda	نذا
negredo	نغريذو
negreira	نغرييرا
neila	نيلا
nerja	نرخا
nerpio	نربيو
nerva	نرفا
nestar	نستار
niebla	نيفلا
nieves	نيفيس
nigran	نيغران
niguelas	نيغيلاس
nijar	نيخار
noain	نواين
noalejo	نواليخو
noblejas	نوفليخاس
noceda	نوثيذا
noez	نويث
nofuentes	نوفوينتيس
nogales	نوغاليس
nograles	نوغراليس
noguera	نوغيرا
nogueruelas	نوغيرويلاس
nois	نويس
nolay	نولاي
nombela	نومبيلا
nonaspe	نوناسبي
noreña	نورينا
novales	نوفاليس
novallas	نوفالياس
novelda	نوفيلدا
noves	نوفيس
novillas	نوفيلياس
noya	نويا
nueno	نوينو
nueva	نويفا
nules	نوليس
nulles	نوليس
numancia	نومانثيا
nuñomoral	نونومورال
obon	أفون
ocaña	أكانا
ocejon	أثيخون
ocentejo	أثينتيخو
ochagavia	أتشاغافيا
ochandiano	أتشانديانو
oden	أذين
odon	أذون
ohanes	أأنيس
oímbra	أيمبرا
ojen	أخين
ojos	أخوس
olalla	ألاليا
olave	ألافي
olazagutia	ألاثاغوتيا
olba	ألفا
oleiros	ألييروس
oliana	أليانا
olias	ألياس
oliete	أليتي
oliola	أليولا
olite	أليتي
oliva	أليفا
olivares	أليفاريس
olivella	أليفيليا
olivenza	أليفينثا
olleria	أليريا
ollo	أليو
olmedillas	ألميذيلياس
olmedo	ألميذو
olmillos	ألميليوس
olocau	ألوكاو
olombrada	ألومبراذا
olost	ألوست
olot	ألوت
olvan	ألفان
olvega	ألفيغا
olvena	ألفينا
olvera	ألفيرا
olza	ألثا
oña	أنا
oñate	أناتي
oncala	أنكالا
onda	أندا
ondara	أندارا
ondarroa	أنداروا
onis	أنيس
ontaneda	أنتانيذا
onteniente	أنتينينتي
ontur	أنتور
onzonilla	أنثونيليا
oquillas	أكيلياس
orbara	أرفارا
orce	أرثي
orcera	أرثيرا
orcheta	أرتشيتا
orduña	أرذونا
orea	أريا
orejo	أريخو
orense	أرينسي
ores	أريس
orgaña	أرغانا
orgaz	أرغاث
orgiva	أرخيفا
oria	أريا
orihuela	أريأيلا
orio	أريو
oris	أريس
orista	أريستا
orle	أرلي
orol	أرول
oropesa	أروبيسا
oroso	أروسو
orozco	أروثكو
orrios	أريوس
orrius	أريوس
orusco	أروسكو
osera	أسيرا
osor	أسور
osorno	أسورنو
ostiz	أستيث
osuna	أسونا
oteiza	أتييثا
oteo	أتيو
otero	أتيرو
otivar	أتيفار
otura	أتورا
oural	أورال
outes	أوتيس
ouviaño	أوفيانو
ovejo	أفيخو
oviedo	أفيذو
oya	أيا
oyarzun	أيارثون
oyon	أيون
ozaeta	أثايتا
padron	باذرون
padul	باذول
paguera	باغيرا
pajares	باخاريس
pajaron	باخارون
pajaroncillo	باخارونثيليو
palafrugell	بالافروخيلي
palamos	بالاموس
palancas	بالانكاس
palanques	بالانكيس
palanquinos	بالانكينوس
palencia	بالينثيا
palenciana	بالينثيانا
palentino	بالينتينو
palenzuela	بالينثويلا
pallares	بالياريس
pallars	باليارس
palleja	باليخا
pallerols	باليرولس
palma	بالما
palo	بالو
palomas	بالوماس
palomeque	بالوميكي
palomera	بالوميرا
pals	بالس
pampliega	بامبليغا
pamplona	بامبلونا
pancorbo	بانكورفو
pancrudo	بانكروذو
panes	بانيس
paniza	بانيثا
panticosa	بانتيكوسا
pantoja	بانتوخا
panton	بانتون
paones	باونيس
papeles	بابيليس
paracuellos	باراكويليوس
paradas	باراذاس
paradaseca	باراذاسيكا
paradela	باراذيلا
paramo	بارامو
parauta	باراوتا
parcent	بارثينت
pardilla	بارذيليا
paredes	باريذيس
pareja	باريخا
parets	باريتس
parga	بارغا
parla	بارلا
parlaba	بارلافا
parres	باريس
parrillas	باريلياس
partaloa	بارتالوا
parzan	بارثان
pasajes	باساخيس
pasaron	باسارون
pastoriza	باستوريثا
pastrana	باسترانا
pauls	باولس
pavias	بافياس
paymogo	بايموغو
pechina	بتشينا
pedralba	بذرالفا
pedralbes	بذرالفيس
pedreguer	بذريغير
pedrera	بذريرا
pedroche	بذروتشي
pedrola	بذرولا
pedroso	بذروسو
pedrouzos	بذرووثوس
pegalajar	بغالاخار
pego	بغو
pelahustan	بلاأستان
peleagonzalo	بلياغونثالو
pelegrina	بليغرينا
peloche	بلوتشي
peñacerrada	بناثيراذا
peñafiel	بنافيل
peñaflor	بنافلور
peñagolosa	بناغولوسا
penagos	بناغوس
peñalba	بنالفا
peñalen	بنالين
peñarrubia	بناروفيا
peñascosa	بناسكوسا
peñausende	بناوسيندي
peniscola	بنيسكولا
pepino	ببينو
peracense	براثينسي
perafita	برافيتا
peral	برال
peralejos	براليخوس
peralta	برالتا
peraltilla	برالتيليا
peralveche	برالفيتشي
peramola	برامولا
peranzanes	برانثانيس
peratallada	براتالياذا
perdiguera	برذيغيرا
perelada	بريلاذا
perello	بريليو
pereña	برينا
pereruela	بريرويلا
periana	بريانا
perorrubio	بروروفيو
pertusa	برتوسا
perves	برفيس
pesaguero	بساغيرو
pescueza	بسكويثا
pesquera	بسكيرا
pesues	بسويس
petin	بتين
pias	بياس
picacho	بيكاتشو
picasent	بيكاسينت
picon	بيكون
picorro	بيكورو
piedrabuena	بيذرافوينا
piedrafita	بيذرافيتا
piedrahita	بيذراإِتا
piera	بيرا
pilas	بيلاس
piloña	بيلونا
pina	بينا
pinar	بينار
pinarejo	بيناريخو
pinarejos	بيناريخوس
pineda	بينيذا
pinet	بينيت
pinillos	بينيليوس
pinofranqueado	بينوفرانكياذو
piñor	بينور
pinos	بينوس
pinoso	بينوسو
pintano	بينتانو
pipaon	بيباون
piqueras	بيكيراس
pira	بيرا
pitillas	بيتيلياس
pizarra	بيثارا
pizarral	بيثارال
plan	بلان
planes	بلانيس
plasencia	بلاسينثيا
plasenzuela	بلاسينثويلا
plencia	بلينثيا
pliego	بليغو
plou	بلوو
pobes	بوفيس
poblete	بوفليتي
poboleda	بوفوليذا
pol	بول
polanco	بولانكو
polenino	بولينينو
polentinos	بولينتينوس
polientes	بولينتيس
pollensa	بولينسا
pollos	بوليوس
polopos	بولوبوس
pomar	بومار
pomer	بومير
ponferrada	بونفيراذا
ponga	بونغا
pons	بونس
pontevedra	بونتيفيذرا
pontones	بونتونيس
pontons	بونتونس
ponzano	بونثانو
porcuna	بوركونا
porquera	بوركيرا
porrera	بوريرا
porreras	بوريراس
porriño	بورينو
porron	بورون
portaje	بورتاخي
porto	بورتو
porzuna	بورثونا
posada	بوساذا
posadas	بوساذاس
posadilla	بوساذيليا
potes	بوتيس
povedilla	بوفيذيليا
poyales	بوياليس
poyatos	بوياتوس
poyo	بويو
poyos	بويوس
pozaldez	بوثالديث
pozoantiguo	بوثوانتيغوو
pozohondo	بوثوأندو
pozondon	بوثوندون
pozorrubio	بوثوروفيو
pozoseco	بوثوسيكو
pozuelo	بوثويلو
pradairo	براذايرو
pradales	براذاليس
pradejon	براذيخون
pradena	براذينا
prades	براذيس
pradillo	براذيليو
prado	براذو
pradoluengo	براذولوينغو
pratdip	براتذيب
pravia	برافيا
preixens	برييكسينس
prejano	بريخانو
priego	بريغو
prioro	بريورو
proaza	برواثا
progalo	بروغالو
pruna	برونا
puenteareas	بوينتيارياس
puentedeume	بوينتيذيومي
puentenansa	بوينتينانسا
puenteviesgo	بوينتيفيسغو
pueyo	بوييو
pujerra	بوخيرا
pulgar	بولغار
pulpi	بولبي
pungin	بونخين
purchena	بورتشينا
purujosa	بوروخوسا
purullena	بورولينا
puzol	بوثول
quart	كوارت
quel	كيل
quemada	كماذا
quero	كرو
quesa	كسا
quesada	كساذا
quintanapalla	كينتاناباليا
quintanavides	كينتانافيذيس
quintanilla	كينتانيليا
quintela	كينتيلا
quinto	كينتو
quiroga	كيروغا
quiros	كيروس
quisicedo	كيسيثيذو
quismondo	كيسموندو
rabade	رافاذي
rabanales	رافاناليس
rabasa	رافاسا
rabo	رافو
radona	راذونا
rafales	رافاليس
ragama	راغاما
ragol	راغول
rajadell	راخاذيلي
ramacastañas	راماكاستاناس
ramallosa	راماليوسا
rascafria	راسكافريا
rasines	راسينيس
raso	راسو
rasquera	راسكيرا
rasueros	راسويروس
reales	راليس
rebalsadores	رفالساذوريس
rebollera	رفوليرا
rebollo	رفوليو
recas	ركاس
redona	رذونا
redondela	رذونديلا
regenjo	رخينخو
reillo	ريليو
reina	رينا
reinosa	رينوسا
relleu	رليو
rellinas	رليناس
rena	رنا
renales	رناليس
renedo	رنيذو
renera	رنيرا
rengos	رنغوس
renteria	رنتيريا
reocin	روثين
requejo	ركيخو
requena	ركينا
resoba	رسوفا
respaldiza	رسبالديثا
restiello	رستيليو
retamal	رتامال
retamosa	رتاموسا
retiendas	رتينداس
reus	روس
revillarruz	رفيلياروث
revolcadores	رفولكاذوريس
riahuelas	رياأيلاس
rialp	ريالب
rianjo	ريانخو
riaño	ريانو
riaza	رياثا
ribadavia	ريفاذافيا
ribadeo	ريفاذيو
ribadesella	ريفاذيسيليا
ribadumia	ريفاذوميا
ribaforada	ريفافوراذا
ribafrecha	ريفافريتشا
ribarredonda	ريفاريذوندا
ribatajada	ريفاتاخاذا
ribesalbes	ريفيسالفيس
ribota	ريفوتا
ricla	ريكلا
ricobayo	ريكوفايو
ricote	ريكوتي
riello	ريليو
rielves	ريلفيس
riglos	ريغلوس
rigoitia	ريغويتيا
rilla	ريليا
riner	رينير
rio	ريو
riobarba	ريوفارفا
riocabado	ريوكافاذو
riocaldo	ريوكالدو
riodeva	ريوذيفا
riofrio	ريوفريو
riogordo	ريوغورذو
rioja	ريوخا
riolobos	ريولوفوس
riopar	ريوبار
rios	ريوس
riosa	ريوسا
riotorto	ريوتورتو
ripoll	ريبولي
ripollet	ريبوليت
risco	ريسكو
riudarenas	ريوذاريناس
riudaura	ريوذاورا
riudecanas	ريوذيكاناس
riudecols	ريوذيكولس
riudoms	ريوذومس
riveira	ريفييرا
rivero	ريفيرو
roa	روا
roales	رواليس
robleda	روفليذا
robledo	روفليذو
robledollano	روفليذوليانو
robres	روفريس
rocallaura	روكالياورا
rociana	روثيانا
rodana	روذانا
rodeiro	روذييرو
rodellar	روذيليار
rodenas	روذيناس
rodiezmo	روذيثمو
rodoña	روذونا
rodos	روذوس
rois	رويس
rojales	روخاليس
rollan	روليان
romanones	رومانونيس
roncal	رونكال
roncesvalles	رونثيسفاليس
ronda	روندا
roquetas	روكيتاس
rosal	روسال
rosas	روساس
rosell	روسيلي
rota	روتا
rotova	روتوفا
royuela	رويويلا
ruanes	روانيس
rubena	روفينا
rubi	روفي
rubiales	روفياليس
rubian	روفيان
rubiana	روفيانا
rubio	روفيو
rubite	روفيتي
rudilla	روذيليا
rueda	رويذا
ruesta	رويستا
ruguilla	روغيليا
ruidera	رويذيرا
rupia	روبيا
rus	روس
rute	روتي
sabadell	سافاذيلي
sabero	سافيرو
sabiñánigo	سافينانيغو
sabiote	سافيوتي
sacañet	ساكانيت
sacedon	ساثيذون
sacedoncillo	ساثيذونثيليو
saceruela	ساثيرويلا
sacramenia	ساكرامينيا
sada	ساذا
sadaba	ساذافا
saelices	سايليثيس
sagaro	ساغارو
sagides	ساخيذيس
sagra	ساغرا
sagunto	ساغونتو
sahagun	ساأغون
salada	سالاذا
salamanca	سالامانكا
salamon	سالامون
salar	سالار
salardu	سالارذو
salas	سالاس
salce	سالثي
salcedo	سالثيذو
saldaña	سالدانا
saldon	سالدون
salduero	سالدويرو
salinas	ساليناس
salinas	ساليناس
sallent	سالينت
salmeron	سالميرون
salmoral	سالمورال
salobral	سالوفرال
salobre	سالوفري
salobrena	سالوفرينا
salomo	سالومو
salorino	سالورينو
salou	سالوو
salsadella	سالساذيليا
salt	سالت
salvacañete	سالفاكانيتي
salvatierra	سالفاتيرا
samboal	سامبوال
samos	ساموس
sampedor	سامبيذور
samper	سامبير
sanabria	سانافريا
sanahuja	ساناأخا
sancedo	سانثيذو
sanchidrian	سانتشيذريان
sanchonuño	سانتشونونو
sandianes	سانديانيس
sando	ساندو
sangenjo	سانخينخو
sangüesa	سانغويسا
sansol	سانسول
santacara	سانتاكارا
santaella	سانتايليا
santany	سانتاني
santibañez	سانتيفانيث
santillana	سانتيليانا
santiso	سانتيسو
santiuste	سانتيوستي
santiz	سانتيث
santolea	سانتوليا
santomera	سانتوميرا
santoña	سانتونا
santovenia	سانتوفينيا
santucri	سانتوكري
santurce	سانتورثي
santurde	سانتورذي
sanzoles	سانثوليس
sapeira	سابييرا
saragossa	ساراغوسا
sariego	ساريغو
sariñena	سارينينا
sarratella	ساراتيليا
sarreal	ساريال
sarreaus	سارياوس
sarria	ساريا
sarrion	ساريون
sarroca	ساروكا
sarvise	سارفيسي
sasamon	ساسامون
sasdonigas	ساسذونيغاس
sastago	ساستاغو
sauca	ساوكا
saucedilla	ساوثيذيليا
saucelle	ساوثيلي
saviñan	سافينان
saviñao	سافيناو
sax	ساكس
sayaton	ساياتون
sebulcor	سفولكور
secorun	سكورون
sedano	سذانو
sedella	سذيليا
segorbe	سغورفي
segurilla	سغوريليا
selaya	سلايا
selgua	سلغوا
sella	سليا
sellano	سليانو
selva	سلفا
semillas	سميلياس
sena	سنا
senes	سنيس
senmanat	سنمانات
senra	سنرا
senterada	سنتيراذا
sepulveda	سبولفيذا
sequeros	سكيروس
serantes	سرانتيس
seriña	سرينا
seron	سرون
seros	سروس
serra	سرا
serrada	سراذا
serradero	سراذيرو
serradilla	سراذيليا
serranillos	سرانيليوس
serrateix	سراتييكس
serrejon	سريخون
sesa	سسا
seseña	سسينا
sesma	سسما
sestao	سستاو
sestrica	سستريكا
setcases	ستكاسيس
setenil	ستينيل
setiles	ستيليس
seva	سفا
sevilla	سفيليا
seville	سفيلي
sierro	سيرو
sietamo	سيتامو
sigüenza	سيغوينثا
sigüés	سيغويس
siles	سيليس
silla	سيليا
silleda	سيليذا
sils	سيلس
simancas	سيمانكاس
sineu	سينيو
sinlabajos	سينلافاخوس
sipan	سيبان
siruela	سيرويلا
sisamon	سيسامون
sisante	سيسانتي
sober	سوفير
sobradillo	سوفراذيليو
sobrado	سوفراذو
sobrelapeña	سوفريلابينا
sobrescobio	سوفريسكوفيو
socobos	سوكوفوس
socuellamos	سوكويلياموس
sodupe	سوذوبي
solares	سولاريس
solera	سوليرا
solivella	سوليفيليا
sollana	سوليانا
soller	سولير
solosancho	سولوسانتشو
solsona	سولسونا
somio	سوميو
somolinos	سومولينوس
somontano	سومونتانو
somontin	سومونتين
somosierra	سوموسيرا
somozas	سوموثاس
soncillo	سونثيليو
sondica	سونديكا
soneja	سونيخا
sopeira	سوبييرا
sorbas	سورفاس
soria	سوريا
sorihuela	سوريأيلا
sorlada	سورلاذا
sorpe	سوربي
sorribes	سوريفيس
sort	سورت
sorzano	سورثانو
soses	سوسيس
sotes	سوتيس
sotiello	سوتيليو
sotodosos	سوتوذوسوس
sotomayor	سوتومايور
sotopalacios	سوتوبالاثيوس
sotos	سوتوس
sotoserrano	سوتوسيرانو
sotresgudo	سوتريسغوذو
sotuelamos	سوتويلاموس
suances	سوانثيس
subijana	سوفيخانا
subirana	سوفيرانا
sucina	سوثينا
sudanell	سوذانيلي
sueca	سويكا
sumbilla	سومبيليا
suria	سوريا
tabara	تافارا
taberno	تافيرنو
taboada	تافواذا
taboadela	تافواذيلا
tabuenca	تافوينكا
tafalla	تافاليا
tahal	تاأل
tahus	تاأس
tal	تال
talamantes	تالامانتيس
talarrubias	تالاروفياس
talavan	تالافان
talayon	تالايون
talayuela	تالايويلا
talayuelas	تالايويلاس
talayuelo	تالايويلو
taliga	تاليغا
talladell	تالياذيلي
tallante	تاليانتي
tamajon	تاماخون
tamame	تامامي
tamames	تاماميس
tamariu	تاماريو
tambre	تامبري
tamurejo	تاموريخو
tapioles	تابيوليس
taracena	تاراثينا
taradell	تاراذيلي
taramundi	تاراموندي
tarancon	تارانكون
taravilla	تارافيليا
tarazona	تاراثونا
tarbena	تارفينا
tardajos	تارذاخوس
tardelcuende	تارذيلكويندي
tardienta	تارذينتا
tarifa	تاريفا
tarija	تاريخا
tarna	تارنا
tarragona	تاراغونا
tarrasa	تاراسا
tarrega	تاريغا
tarrio	تاريو
tarroja	تاروخا
tarros	تاروس
tauste	تاوستي
tavaruela	تافارويلا
tazones	تاثونيس
teba	تفا
tebar	تفار
tejadillos	تخاذيليوس
tejares	تخاريس
tejeiro	تخييرو
tejera	تخيرا
tembleque	تمبليكي
tempul	تمبول
tendilla	تنديليا
tenebron	تنيفرون
teo	تو
termens	ترمينس
termino	ترمينو
terminon	ترمينون
terradas	تراذاس
terriente	ترينتي
terrinches	ترينتشيس
terroba	تروفا
teruel	ترويل
teulada	تولاذا
teverga	تفيرغا
tiana	تيانا
tibi	تيفي
tibidabo	تيفيذافو
tiebas	تيفاس
tiedra	تيذرا
tielve	تيلفي
tierga	تيرغا
tiermas	تيرماس
tierzo	تيرثو
tiesa	تيسا
tijola	تيخولا
tinajas	تيناخاس
tineo	تينيو
tiñosillos	تينوسيليوس
tirgo	تيرغو
tirig	تيريغ
tirteafuera	تيرتيافويرا
titaguas	تيتاغواس
tiurana	تيورانا
tivenys	تيفينيس
tivisa	تيفيسا
tobarra	توفارا
tobia	توفيا
tocina	توثينا
todellego	توذيليغو
todolella	توذوليليا
toledo	توليذو
tolocirio	تولوثيريو
tolosa	تولوسا
tolox	تولوكس
tolva	تولفا
tomelloso	توميليوسو
tomiño	تومينو
tona	تونا
topares	توباريس
toques	توكيس
tor	تور
tora	تورا
toras	توراس
tordehumos	تورذيأموس
tordera	تورذيرا
tordomar	تورذومار
tordoya	تورذويا
torello	توريليو
toreno	تورينو
torija	توريخا
toril	توريل
torla	تورلا
tormon	تورمون
tornavacas	تورنافاكاس
toro	تورو
torquemada	توركيماذا
torralba	تورالفا
torreadrada	تورياذراذا
torrebeleña	توريفيلينا
torrebeses	توريفيسيس
torrecaballeros	توريكافاليروس
torrecampo	توريكامبو
torrecilla	توريثيليا
torredembarra	توريذيمبارا
torredonjimeno	توريذونخيمينو
torrefarrera	توريفاريرا
torregrosa	توريغروسا
torreiglesias	تورييغليسياس
torrejoncillo	توريخونثيليو
torrelaguna	توريلاغونا
torrelapaja	توريلاباخا
torrelavega	توريلافيغا
torrellano	توريليانو
torrellas	توريلياس
torrelobaton	توريلوفاتون
torrelodones	توريلوذونيس
torremanzanas	توريمانثاناس
torremayor	توريمايور
torremegia	توريميخيا
torremocha	توريموتشا
torremolinos	توريمولينوس
torremontalbo	توريمونتالفو
torrente	تورينتي
torrenueva	تورينويفا
torreorgaz	توريورغاث
torreperogil	توريبيروخيل
torrequebradilla	توريكيفراذيليا
torrequemada	توريكيماذا
torres	توريس
torresandino	توريساندينو
torresmenudas	توريسمينوذاس
torrevelilla	توريفيليليا
torrevieja	توريفيخا
torrijas	توريخاس
torrijo	توريخو
torrijos	توريخوس
torronteras	تورونتيراس
torrox	توروكس
tortajada	تورتاخاذا
tortella	تورتيليا
tortola	تورتولا
tortonda	تورتوندا
tortuera	تورتويرا
tortuero	تورتويرو
torviscon	تورفيسكون
torviscoso	تورفيسكوسو
tosas	توساس
totana	توتانا
totanes	توتانيس
touro	توورو
tous	تووس
trabada	ترافاذا
trabadelo	ترافاذيلو
trabanca	ترافانكا
trabazos	ترافاثوس
tragacete	تراغاثيتي
traiguera	ترايغيرا
tramacastilla	تراماكاستيليا
trasierra	تراسيرا
traslavina	تراسلافينا
trasmiras	تراسميراس
trasobares	تراسوفاريس
traspinedo	تراسبينيذو
trazo	تراثو
trebujena	تريفوخينا
tredos	تريذوس
tremp	تريمب
tresjuncos	تريسخونكوس
treto	تريتو
trevelez	تريفيليث
treviana	تريفيانا
trevias	تريفياس
treviño	تريفينو
triacastela	ترياكاستيلا
trigueros	تريغيروس
trillo	تريليو
triollo	تريوليو
triste	تريستي
troncedo	ترونثيذو
tronchon	ترونتشون
trubia	تروفيا
truchas	تروتشاس
truchillas	تروتشيلياس
trujillanos	تروخيليانوس
trujillo	تروخيليو
trujillos	تروخيليوس
tudanca	توذانكا
tudela	توذيلا
tuejar	تويخار
tulebras	توليفراس
turcia	تورثيا
turegano	توريغانو
turis	توريس
turleque	تورليكي
turon	تورون
turre	توري
turrillas	توريلياس
turruncun	تورونكون
tuy	توي
ubeda	أفيذا
ubidea	أفيذيا
ubrique	أفريكي
uceda	أثيذا
ucero	أثيرو
udias	أذياس
ugijar	أخيخار
ujo	أخو
ujue	أخوي
ulea	أليا
ulldecona	أليديكونا
ulldemolins	أليديمولينس
umbrete	أمبريتي
uña	أنا
uncastillo	أنكاستيليو
unquera	أنكيرا
unzue	أنثوي
urbies	أرفيس
urda	أرذا
urracal	أراكال
urries	أريس
urroz	أروث
urueña	أروينا
urueñas	أرويناس
usagre	أساغري
used	أسيذ
useras	أسيراس
utebo	أتيفو
utiel	أتيل
utrera	أتريرا
utrillas	أتريلياس
uztarroz	أثتاروث
vadocondes	باذوكونديس
vadollano	باذوليانو
valacloche	بالاكلوتشي
valcavadillo	بالكافاذيليو
valdaracete	بالداراثيتي
valdarachas	بالداراتشاس
valdeajos	بالدياخوس
valdeavero	بالديافيرو
valdeaveruelo	بالديافيرويلو
valdecaballeros	بالديكافاليروس
valdecabras	بالديكافراس
valdecarros	بالديكاروس
valdecebollas	بالديثيفولياس
valdecebro	بالديثيفرو
valdeconcha	بالديكونتشا
valdeconejos	بالديكونيخوس
valdecuenca	بالديكوينكا
valdedios	بالديذيوس
valdefresno	بالديفريسنو
valdefuentes	بالديفوينتيس
valdegamas	بالديغاماس
valdeganga	بالديغانغا
valdegovia	بالديغوفيا
valdehijaderos	بالديإِخاذيروس
valdelagua	بالديلاغوا
valdelaguna	بالديلاغونا
valdelcubo	بالديلكوفو
valdelinares	بالديليناريس
valdelosa	بالديلوسا
valdelugueros	بالديلوغيروس
valdemaluque	بالديمالوكي
valdemorillo	بالديموريليو
valdemoro	بالديمورو
valdenoceda	بالدينوثيذا
valdenoches	بالدينوتشيس
valdeobispo	بالديوفيسبو
valdeolivas	بالديوليفاس
valdeorras	بالديوراس
valdepeñas	بالديبيناس
valdepielago	بالديبيلاغو
valdepolo	بالديبولو
valdeprados	بالديبراذوس
valderas	بالديراس
valderrey	بالديريي
valderrobres	بالديروفريس
valdesamario	بالديساماريو
valdesaz	بالديساث
valdespina	بالديسبينا
valdespino	بالديسبينو
valdestillas	بالديستيلياس
valdeteja	بالديتيخا
valdetorres	بالديتوريس
valdevimbre	بالديفيمبري
valdezarza	بالديثارثا
valdihuelo	بالديأيلو
valdilecha	بالديليتشا
valdoviño	بالدوفينو
valdunquillo	بالدونكيليو
valencia	بالينثيا
valenzuela	بالينثويلا
valeria	باليريا
valga	بالغا
valjunquera	بالخونكيرا
vallada	بالياذا
valladolises	بالياذوليسيس
vallanca	باليانكا
vallbona	باليفونا
valldemosa	باليديموسا
valle	بالي
vallecas	باليكاس
vallelado	باليلاذو
vallfogona	باليفوغونا
vallibona	باليفونا
vallirana	باليرانا
vallmoll	باليمولي
vallromanas	باليروماناس
valls	باليس
valmala	بالمالا
valmaseda	بالماسيذا
valmojado	بالموخاذو
valnera	بالنيرا
valor	بالور
valronquillo	بالرونكيليو
valseca	بالسيكا
valsequillo	بالسيكيليو
valtajeros	بالتاخيروس
vandellos	بانديليوس
vañes	بانيس
vascongadas	باسكونغاذاس
vecinos	بثينوس
vedra	بذرا
vegadeo	بغاذيو
vegamian	بغاميان
veganzones	بغانثونيس
vegapagar	بغاباغار
vegaquemada	بغاكيماذا
vegarienza	بغارينثا
velada	بلاذا
velascalvaro	بلاسكالفارو
velefique	بليفيكي
velilla	بليليا
vellisca	بليسكا
vendrell	بندريلي
venialbo	بنيالفو
ventas	بنتاس
ventillas	بنتيلياس
venturada	بنتوراذا
vera	برا
verdu	برذو
verea	بريا
veredas	بريذاس
vergara	برغارا
vergel	برخيل
verges	برخيس
verin	برين
vezdemarban	بثذيمارفان
viacamp	بياكامب
viana	بيانا
vianos	بيانوس
viascon	بياسكون
viator	بياتور
vicalvaro	بيكالفارو
vicar	بيكار
vicien	بيثين
vicolozano	بيكولوثانو
vidangoz	بيذانغوث
vidiago	بيذياغو
vidreras	بيذريراس
viella	بيليا
viguera	بيغيرا
vilabella	بيلافيليا
vilaboa	بيلافوا
vilada	بيلاذا
vilademat	بيلاذيمات
vilademuls	بيلاذيمولس
viladrau	بيلاذراو
vilagrasa	بيلاغراسا
vilaller	بيلالير
vilanova	بيلانوفا
vilaplana	بيلابلانا
vilapouca	بيلابووكا
vilarrodona	بيلاروذونا
vilaseca	بيلاسيكا
vilatan	بيلاتان
vilches	بيلتشيس
villabona	بيليافونا
villacañas	بيلياكاناس
villacarriedo	بيلياكاريذو
villacarrillo	بيلياكاريليو
villacastin	بيلياكاستين
villaconejos	بيلياكونيخوس
villada	بيلياذا
villadecanes	بيلياذيكانيس
villadepera	بيلياذيبيرا
villadiego	بيلياذيغو
villaescusa	بيليايسكوسا
villafames	بيليافاميس
villaflores	بيليافلوريس
villafranca	بيليافرانكا
villafranqueza	بيليافرانكيثا
villafrechos	بيليافريتشوس
villafruela	بيليافرويلا
villagaton	بيلياغاتون
villager	بيلياخير
villagonzalo	بيلياغونثالو
villahermosa	بيلياإِرموسا
villahoz	بيلياأث
villajoyosa	بيلياخويوسا
villalba	بيليالفا
villalengua	بيليالينغوا
villalmanzo	بيليالمانثو
villalonga	بيليالونغا
villalpando	بيليالباندو
villalube	بيليالوفي
villaluenga	بيليالوينغا
villalumbroso	بيليالومبروسو
villalvaro	بيليالفارو
villamalea	بيلياماليا
villamalur	بيليامالور
villamañan	بيليامانان
villamandos	بيلياماندوس
villamanrique	بيليامانريكي
villamanta	بيليامانتا
villamantilla	بيليامانتيليا
villamarin	بيليامارين
villamartin	بيليامارتين
villamayor	بيليامايور
villamea	بيلياميا
villamediana	بيلياميذيانا
villamejil	بيلياميخيل
villamesias	بيلياميسياس
villamizar	بيلياميثار
villamol	بيليامول
villamuelas	بيليامويلاس
villanúa	بيليانوا
villanubla	بيليانوفلا
villanueva	بيليانويفا
villaobispo	بيلياوفيسبو
villapalacios	بيليابالاثيوس
villaquejida	بيلياكيخيذا
villaquilambre	بيلياكيلامبري
villaralbo	بيليارالفو
villaralto	بيليارالتو
villarejo	بيلياريخو
villarente	بيليارينتي
villaricos	بيلياريكوس
villarino	بيليارينو
villarrabe	بيليارافي
villarramiel	بيلياراميل
villarrasa	بيلياراسا
villarreal	بيلياريال
villarrobledo	بيلياروفليذو
villarrodrigo	بيلياروذريغو
villarroya	بيليارويا
villarrubia	بيلياروفيا
villarrubio	بيلياروفيو
villasabariego	بيلياسافاريغو
villasandino	بيلياساندينو
villasante	بيلياسانتي
villasarracino	بيلياساراثينو
villasayas	بيلياساياس
villaseca	بيلياسيكا
villaselan	بيلياسيلان
villasilos	بيلياسيلوس
villasrubias	بيلياسروفياس
villastar	بيلياستار
villatobas	بيلياتوفاس
villatoro	بيلياتورو
villatoya	بيلياتويا
villaturiel	بيلياتوريل
villava	بيليافا
villavaquerin	بيليافاكيرين
villavendimio	بيليافينديميو
villaviciosa	بيليافيثيوسا
villaviudas	بيليافيوذاس
villayon	بيليايون
villaza	بيلياثا
villegas	بيليغاس
villel	بيليل
villena	بيلينا
villerias	بيليرياس
villodrigo	بيليوذريغو
villoldo	بيليولدو
villora	بيليورا
villores	بيليوريس
villoria	بيليوريا
vilvestre	بيلفيستري
vimianzo	بيميانثو
vinaceite	بيناثييتي
vinaroz	بيناروث
vindel	بينديل
vinebre	بينيفري
viñuela	بينويلا
viñuelas	بينويلاس
vinuesa	بينويسا
viruela	بيرويلا
visaurin	بيساورين
visiedo	بيسيذو
vitigudino	بيتيغوذينو
viver	بيفير
vivero	بيفيرو
viveros	بيفيروس
vizcaínos	بيثكاينوس
vizmanos	بيثمانوس
yanguas	يانغواس
yatova	ياتوفا
yebes	يفيس
yebra	يفرا
yecla	يكلا
yegen	يخين
yela	يلا
yepes	يبيس
yerga	يرغا
yesa	يسا
yeste	يستي
yuncler	يونكلير
yuncos	يونكوس
yunquera	يونكيرا
zafarraya	ثافارايا
zagra	ثاغرا
zahara	ثاأرا
zahinos	ثاإِنوس
zaidin	ثايذين
zalla	ثاليا
zamarramala	ثامارامالا
zamayon	ثامايون
zambra	ثامبرا
zambrana	ثامبرانا
zamora	ثامورا
zaorejas	ثاوريخاس
zaragoza	ثاراغوثا
zaratan	ثاراتان
zarauz	ثاراوث
zarra	ثارا
zarzalejo	ثارثاليخو
zas	ثاس
zizur	ثيثور
zorita	ثوريتا
zubia	ثوفيا
zubieta	ثوفيتا
zubiri	ثوفيري
zucaina	ثوكاينا
zudaire	ثوذايري
zuera	ثويرا
zuheros	ثوإِروس
zujar	ثوخار
zumarraga	ثوماراغا
zumaya	ثومايا
zuniga	ثونيغا
zurgena	ثورخينا
zurzarren	ثورثارين
