Abelo	آبيلو
Artikoloj	آرتيکولوي
Bakterioj	باکتيريوي
Barato	باراتو
Beziero	بيزييرو
Biologia	بيولوگيا
Biologio	بيولوگيو
Celsiuso	تسيلسيوسو
Daŭro	داورو
Dum	دوم
Eble	ايبله
Ekzemple	ايکزيمپله
Feniciaj	فينيتسياي
Fojfoje	فويفويا
Germanio	گيرمانيو
Glukozo	گلوکوزو
Gvineo	گوينيو
Hemoglobino	هيموگلوبينو
Heredaĵo	هيريداژو
Historio	هيستوريو
Ilia	ايليا
Inter	اينتير
Jakobo	ياکوبو
Kaj	کاي
Kazeino	کازيينو
Kelkaj	کيلکاي
Kelkfoje	کيلکفويا
Kiam	کيام
Koloroj	کولوروي
Kompare	کومپاره
Krom	کروم
Kurbo	کوربو
Lakto	لاکتو
Laŭ	لاو
Lia	ليا
Lumo	لومو
Malsimile	مالسيميله
Manĝu	ماندژو
Mediteraneo	ميديتيرانيو
Mezepoko	ميزيپوکو
Mielo	مييلو
Mikroorganismoj	ميکروورگانيسموي
Motelo	موتيلو
Moteloj	موتيلوي
Multaj	مولتاي
Muttermilch	موتتيرميلتسه
Neseksa	نيسيکسا
Nov	نوو
Nuntempe	نونتيمپه
Oni	اوني
Organizaĵo	اورگانيزاژو
Oĝalan'	اودژالان
Patrina	پاترينا
Paul	پاول
Per	پير
Pierre	پييرره
Pli	پلي
Plie	پليه
Por	پور
Poste	پوسته
Precipe	پريتسيپه
Priskribo	پريسکريبو
Prokarioto	پروکاريوتو
Proteino	پروتيينو
Radiositeo	راديوسيتيو
Referencoj	ريفيرينتسوي
Samtempe	سامتيمپه
Sano	سانو
Sekve	سيکوه
Sepdek	سيپديک
Simbolismo	سيمبوليسمو
Simile	سيميله
Studkampoj	ستودکامپوي
Subkonscio	سوبکونستسيو
Sur	سور
Svingodanco	سوينگودانتسو
Talpa	تالپا
Tamen	تامين
Temas	تيماس
Tiu	تيو
Tiuj	تيوي
Transportante	ترانسپورتانته
Tre	تره
Unu	اونو
Uzado	اوزادو
Vakso	واکسو
Vektora	ويکتورا
Vidu	ويدو
Vintre	وينتره
alkoholo	آلکوهولو
aperintaj	آپيرينتاي
bata	باتا
batanto	باتانتو
bestaj	بيستاي
besto	بيستو
bildigo	بيلديگو
bildon	بيلدون
blanka	بلانکا
blankiginte	بلانکيگينته
bloko	بلوکو
bova	بووا
bovino	بووينو
branĉoj	برانتشوي
brazila	برازيلا
bruna	برونا
buterlakton	بوتيرلاکتون
buteron	بوتيرون
casa	تساسا
celoj	تسيلوي
centprocente	تسينتپروتسينته
cifereca	تسيفيريتسا
cisterna	تسيستيرنا
curve	تسوروه
dancistinon	دانتسيستينون
danco	دانتسو
deakvigo	دياکويگو
depona	ديپونا
disfalos	ديسفالوس
distancon	ديستانتسون
do	دو
domon	دومون
du	دو
duoninsulon	دوونينسولون
edzo	ايدزو
enzimojn	اينزيموين
eĝaj	ايدژاي
faligi	فاليگي
famili’	فاميلي
faritaj	فاريتاي
fermentataj	فيرمينتاتاي
feron	فيرون
fidindeco	فيدينديتسو
fizikajn	فيزيکاين
flanke	فلانکه
flankoj	فلانکوي
florantaj	فلورانتاي
florpoleno	فلورپولينو
fluetigita	فلويتيگيتا
flugante	فلوگانته
fosas	فوساس
fosforo	فوسفورو
franca	فرانتسا
fratinoj	فراتينوي
freŝe	فريشه
fromaĝon	فرومادژون
frostaj	فروستاي
frukto	فروکتو
fruktozo	فروکتوزو
funkcio	فونکتسيو
furaĝ	فورادژ
gardi	گاردي
gasojn	گاسوين
gelato	گيلاتو
genetikan	گينيتيکان
glandoj	گلاندوي
glukozo	گلوکوزو
grasumo	گراسومو
gravega	گراويگا
grekaj	گريکاي
grumas	گروماس
grundo	گروندو
gustadon	گوستادون
gusto	گوستو
havi	هاوي
havus	هاووس
helflava	هيلفلاوا
hemoglobino	هيموگلوبينو
hidrogeno	هيدروگينو
histojn	هيستوين
homan	هومان
hotelo	هوتيلو
humido	هوميدو
informa	اينفورما
insektoj	اينسيکتوي
jarcento	يارتسينتو
jaroj	ياروي
je	ي
jodo	يودو
jogurton	يوگورتون
ju	يو
junaj	يوناي
kalkulo	کالکولو
kaprino	کاپرينو
ke	که
kelkfoje	کيلکفويا
kiam	کيام
kies	کييس
kloroplastoj	کلوروپلاستوي
konservebla	کونسيرويبلا
kovrataj	کووراتاي
kreas	کرياس
kreskoŝancon	کريسکوشانتسون
kriket	کريکيت
kriketo	کريکيتو
krome	کرومه
kruca	کروتسا
krudmaterialo	کرودماتيريالو
ktp	کتپ
kuro	کورو
kuroj	کوروي
kvankam	کوانکام
kvar	کوار
kvin	کوين
laboristinoj	لابوريستينوي
laktoartikloj	لاکتوارتيکلوي
leksikono	ليکسيکونو
leĝoj	ليدژوي
ligoj	ليگوي
lipidoj	ليپيدوي
longtempe	لونگتيمپه
loĝas	لودژاس
ludantoj	لودانتوي
ludas	لوداس
matematiko	ماتيماتيکو
maŝinoj	ماشينوي
mensan	مينسان
metodojn	ميتودوين
mikroskope	ميکروسکوپه
miricil	ميريتسيل
mm	مم
molekuloj	موليکولوي
mortiga	مورتيگا
muliebre	مولييبره
muskatoj	موسکاتوي
nOT	نوت
natura	ناتورا
nature	ناتوره
nehoma	نيهوما
neracia	نيراتسيا
ni	ني
nivelo	نيويلو
normale	نورماله
novembro	نوويمبرو
nutraj	نوتراي
nutraĵindustrio	نوتراژيندوستريو
oni	اوني
opiniataj	اوپينياتاي
palmitata	پالميتاتا
parencaj	پارينتساي
perceptas	پيرتسيپتاس
permesas	پيرميساس
pikilo	پيکيلو
pinĉileto	پينتشيليتو
plantaron	پلانتارون
plantoj	پلانتوي
plejparto	پلييپارتو
plenkreskuloj	پلينکريسکولوي
pliigis	پلييگيس
plimulto	پليمولتو
plurdisciplina	پلورديستسيپلينا
plurlatero	پلورلاتيرو
por	پور
pozicio	پوزيتسيو
prahistorio	پراهيستوريو
praktiko	پراکتيکو
prelego	پريليگو
preskaŭ	پريسکاو
pri	پري
priparolata	پريپارولاتا
propoliso	پروپوليسو
protekto	پروتيکتو
pruvita	پروويتا
pseŭdovektoro	پسيودوويکتورو
pseŭdovektoroj	پسيودوويکتوروي
psikologia	پسيکولوگيا
psikologio	پسيکولوگيو
publikigita	پوبليکيگيتا
putrantajn	پوترانتاين
rapida	راپيدا
rapide	راپيده
reale	رياله
rezulton	ريزولتون
rikoltas	ريکولتاس
ripetfoje	ريپيتفويا
rolon	رولون
rostron	روسترون
ruinigata	روينيگاتا
ruĝa	رودژا
samaj	ساماي
saman	سامان
sciojn	ستسيوين
sensojn	سينسوين
ses	سيس
siajn	سياين
simple	سيمپله
skalo	سکالو
skatolo	سکاتولو
skribi	سکريبي
skribitaj	سکريبيتاي
solvema	سولويما
sovaĝaj	سووادژاي
spaco	سپاتسو
speco	سپيتسو
specoj	سپيتسوي
spicoj	سپيتسوي
spina	سپينا
sporto	سپورتو
sprajilo	سپراييلو
stabilecon	ستابيليتسون
stabiligitan	ستابيليگيتان
sterkon	ستيرکون
stoka	ستوکا
struktura	ستروکتورا
strukturo	ستروکتورو
studado	ستودادو
studitaj	ستوديتاي
sukoj	سوکوي
surfaco	سورفاتسو
svarmado	سوارمادو
svingodanco	سوينگودانتسو
tamen	تامين
taskoj	تاسکوي
terapio	تيراپيو
teritorio	تيريتوريو
tiuj	تيوي
tiuspeca	تيوسپيتسا
tra	ترا
traktoroj	تراکتوروي
tre	تره
tri	تري
trinkado	ترينکادو
trovas	تروواس
troviĝas	تروويدژاس
tubo	توبو
tuŝadon	توشادون
uzado	اوزادو
uzo	اوزو
vaksĉelaro	واکستشيلارو
vaporon	واپورون
vera	ويرا
vertikalon	ويرتيکالون
vi	وي
vino	وينو
volumeno	وولومينو
vorta	وورتا
vorto-provizo	وورتوپروويزو
vundokrustoj	ووندوکروستوي
zinko	زينکو
zumado	زومادو
zumadon	زومادون
Ĉar	تشار
Ĉe	تشه
Ĉi	تشي
ĉar	تشار
ĉevalino	تشيوالينو
ĉevalo	تشيوالو
ĉiuj	تشيوي
ĉiujn	تشيوين
ĉu	تشو
Ĝardenaferoj	دژاردينافيروي
Ĝeneraligoj	دژينيراليگوي
Ĝi	دژي
Ĝia	دژيا
ĝardeno	دژاردينو
ĝardenoj	دژاردينوي
ĝeneralaj	دژينيرالاي
ĝenerale	دژينيراله
ĝin	دژين
ĝis	دژيس
ĝusta	دژوستا
Ĥemia	خيميا
Ĥemio	خيميو
ĥemia	خيميا
ĵetas	ژيتاس
ĵetintan	ژيتينتان
Ŝprucigilo	شپروتسيگيلو
Ŝprucigiloj	شپروتسيگيلوي
ŝafino	شافينو
ŝanĝi	شاندژي
ŝi	شي
ŝmirajoj	شميرايوي
ŝoseoj	شوسيوي
ŝprucigi	شپروتسيگي
ŝprucigilo	شپروتسيگيلو
ŝtrato	شتراتو
ŭa	اوا
Ŭaŝingtono	اواشينگتونو
