ababuj	آواووخ
abades	آواذيس
abadia	آواذيا
abadiano	آواذيانو
abadin	آواذين
abanades	آواناذيس
abanilla	آوانيليا
abaran	آواران
abegondo	آويغوندو
abejar	آويخار
abejuela	آويخويلا
abengibra	آوينخيورا
abenojar	آوينوخار
abiego	آويغو
abla	آولا
ablitas	آوليتاس
abrera	آوريرا
abrucena	آوروثينا
acebo	آثيوو
acedera	آثيذيرا
acehuche	آثياوچه
aceuchal	آثيوچال
acrijos	آکريخوس
adahuesca	آذااويسکا
adamuz	آذاموث
adanero	آذانيرو
aday	آذاي
adeje	آذيخه
ademuz	آذيموث
ador	آذور
adra	آذرا
adradas	آذراذاس
adrados	آذراذوس
adzaneta	آذثانيتا
agaete	آغايته
ager	آخير
agoncillo	آغونثيليو
agost	آغوست
agramon	آغرامون
agramunt	آغرامونت
agreda	آغريذا
agres	آغريس
agron	آغرون
aguadulce	آغواذولثه
aguamansa	آغوامانسا
aguaron	آغوارون
aguas	آغواس
aguaviva	آغواويوا
agudo	آغوذو
agüera	آغويرا
agüero	آغويرو
aguila	آغيلا
aguilafuente	آغيلافوينته
aguilas	آغيلاس
agüimes	آغويميس
agullana	آغوليانا
agulo	آغولو
ahigal	آايغال
ahillones	آايليونيس
aianis	آيانيس
aibar	آيوار
aiguamurcia	آيغوامورثيا
ainsa	آينسا
aizpun	آيثپون
ajamil	آخاميل
alaejos	آلايخوس
alagon	آلاغون
alajar	آلاخار
alajero	آلاخيرو
alameda	آلاميذا
alamedilla	آلاميذيليا
alamillo	آلاميليو
alaminos	آلامينوس
alange	آلانخه
alarcon	آلارکون
alarilla	آلاريليا
alaro	آلارو
alatoz	آلاتوث
alayor	آلايور
alba	آلوا
albacete	آلواثيته
albages	آلواخيس
albaladejo	آلوالاذيخو
albalatillo	آلوالاتيليو
albana	آلوانا
albanchez	آلوانچيث
albares	آلواريس
albarracin	آلواراثين
albatana	آلواتانا
albatera	آلواتيرا
albendea	آلوينديا
albendin	آلويندين
albentosa	آلوينتوسا
alberique	آلويريکه
alberite	آلويريته
albesa	آلويسا
albinana	آلوينانا
albocacer	آلووکاثير
alboloduy	آلوولوذوي
albolote	آلوولوته
albondon	آلووندون
alboraya	آلوورايا
alborea	آلووريا
albox	آلووکس
albudeite	آلووذييته
albujon	آلووخون
albuñol	آلوونول
albuñuelas	آلوونويلاس
alcadozo	آلکاذوثو
alcaine	آلکاينه
alcampel	آلکامپيل
alcanadre	آلکاناذره
alcanar	آلکانار
alcanices	آلکانيثيس
alcaniz	آلکانيث
alcantara	آلکانتارا
alcantarilla	آلکانتاريليا
alcantud	آلکانتوذ
alcaracejos	آلکاراثيخوس
alcaraz	آلکاراث
alcarras	آلکاراس
alcaucin	آلکاوثين
alcaudete	آلکاوذيته
alcazaren	آلکاثارين
alceda	آلثيذا
alcira	آلثيرا
alcoba	آلکووا
alcobendas	آلکووينداس
alcocebre	آلکوثيوره
alcocer	آلکوثير
alcohujate	آلکواوخاته
alcolea	آلکوليا
alcollarin	آلکوليارين
alconchel	آلکونچيل
alconera	آلکونيرا
alcontar	آلکونتار
alcora	آلکورا
alcorisa	آلکوريسا
alcoroches	آلکوروچيس
alcover	آلکووير
alcoy	آلکوي
alcubierre	آلکوويره
alcubillas	آلکوويلياس
alcublas	آلکوولاس
alcudia	آلکوذيا
alcuescar	آلکويسکار
alcuneza	آلکونيثا
aldaya	آلدايا
aldea	آلديا
aldeacentenera	آلدياثينتينيرا
aldealpozo	آلديالپوثو
aldeaquemada	آلدياکيماذا
aldearrodrigo	آلدياروذريغو
aldeavieja	آلدياويخا
aldehuela	آلدياويلا
aldeire	آلدييره
aldover	آلدووير
aledo	آليذو
alegria	آليغريا
alerre	آليره
aleson	آليسون
alfacar	آلفاکار
alfaiz	آلفايث
alfajarin	آلفاخارين
alfambra	آلفامبرا
alfamen	آلفامين
alfara	آلفارا
alfaraz	آلفاراث
alfaro	آلفارو
alfarras	آلفاراس
alfoz	آلفوث
algaida	آلغايذا
algamitas	آلغاميتاس
algarinejo	آلغارينيخو
algarra	آلغارا
algarrobo	آلغاروو
algatocin	آلغاتوثين
algeciras	آلخيثيراس
algemesi	آلخيميسي
algete	آلخيته
alginet	آلخينيت
algodonales	آلغوذوناليس
algora	آلغورا
algria	آلغريا
alguaire	آلغوايره
alguazas	آلغواثاس
algueña	آلغينا
alia	آليا
aliaga	آلياغا
alicante	آليکانته
aliseda	آليسيذا
aljaraque	آلخاراکه
aljibe	آلخيوه
aljorra	آلخورا
aljucen	آلخوثين
allariz	آلياريث
allepuz	آليپوث
aller	آلير
alles	آليس
allo	آليو
alloza	آليوثا
almacellas	آلماثيلياس
almachar	آلماچار
almaciles	آلماثيليس
almaden	آلماذين
almadenejos	آلماذينيخوس
almadrones	آلماذرونيس
almagro	آلماغرو
almajano	آلماخانو
almaluez	آلمالويث
almansa	آلمانسا
almanza	آلمانثا
almaraz	آلماراث
almatret	آلماتريت
almazan	آلماثان
almazora	آلماثورا
almazul	آلماثول
almedina	آلميذينا
almedinilla	آلميذينيليا
almegijar	آلميخيخار
almeida	آلمييذا
almenar	آلمينار
almenara	آلمينارا
almendra	آلميندرا
almendral	آلميندرال
almendralejo	آلميندراليخو
almendricos	آلميندريکوس
almendros	آلميندروس
almeria	آلميريا
almogia	آلموخيا
almoguera	آلموغيرا
almohaja	آلموآخا
almoharin	آلموآرين
almonte	آلمونته
almoradi	آلموراذي
almorox	آلموروکس
almudebar	آلموذيوار
almuñécar	آلمونيکار
almuniente	آلمونينته
almuradiel	آلموراذيل
almusafes	آلموسافيس
alobras	آلووراس
alocen	آلوثين
alora	آلورا
alos	آلوس
alosno	آلوسنو
alovera	آلوويرا
alozaina	آلوثاينا
alp	آلپ
alpandeire	آلپاندييره
alpanseque	آلپانسيکه
alpedroches	آلپيذروچيس
alpeñés	آلپينيس
alpens	آلپينس
alpera	آلپيرا
alperiz	آلپيريث
alpuente	آلپوينته
alquezar	آلکيثار
alsasua	آلساسوا
altable	آلتاوله
altamira	آلتاميرا
altarejos	آلتاريخوس
altea	آلتيا
altorricon	آلتوريکون
altoteiro	آلتوتييرو
altura	آلتورا
alustante	آلوستانته
alvires	آلويريس
alzola	آلثولا
amaya	آمايا
amer	آمير
ames	آميس
ameyugo	آمييوغو
amezaga	آميثاغا
amieva	آميوا
amoeiro	آموييرو
amorebieta	آموريويتا
amposta	آمپوستا
ampudia	آمپوذيا
ampuero	آمپويرو
ampurias	آمپورياس
amurrio	آموريو
amusco	آموسکو
aña	آنا
anchuras	آنچوراس
ancin	آنثين
andalucia	آندالوثيا
andavias	آنداوياس
andilla	آنديليا
andoain	آندواين
andorra	آندورا
andosilla	آندوسيليا
andraitx	آندرايچ
andujar	آندوخار
angles	آنگليس
anglesola	آنگليسولا
angüés	آنگويس
anguiano	آنگيانو
anguix	آنگيکس
aniñón	آنينون
anleo	آنليو
añon	آنون
añora	آنورا
anso	آنسو
antas	آنتاس
antequera	آنتيکيرا
antigüedad	آنتيغويذاذ
antonaña	آنتونانا
anzanigo	آنثانيغو
anzuola	آنثوولا
anzur	آنثور
apatamonasterio	آپاتاموناستيريو
apellaniz	آپيليانيث
aquilue	آکيلوه
aracena	آراثينا
arafo	آرافو
aragon	آراغون
aragoncillo	آراغونثيليو
aranarache	آراناراچه
aranaz	آراناث
arandillo	آرانديليو
aranjuez	آرانخويث
arano	آرانو
aranzazu	آرانثاثو
aranzuegue	آرانثويغه
arapiles	آراپيليس
aras	آراس
aravaca	آراواکا
araya	آرايا
arbeca	آرويکا
arbo	آروو
arbos	آرووس
arceniega	آرثينيغا
archena	آرچينا
archilla	آرچيليا
arcos	آرکوس
arcusa	آرکوسا
ardisa	آرذيسا
aren	آرين
arenas	آريناس
areo	آريو
ares	آريس
areta	آريتا
arevalillo	آريواليليو
arevalo	آريوالو
arganda	آرغاندا
arganza	آرغانثا
arguedas	آرغيذاس
arguellite	آرغيليته
arguineguin	آرغينيغين
arguis	آرغيس
arija	آريخا
arinaga	آريناغا
ariñez	آرينيث
ariño	آرينو
arive	آريوه
ariza	آريثا
arizala	آريثالا
arjona	آرخونا
arjonilla	آرخونيليا
arlanzon	آرلانثون
armuna	آرمونا
arnedillo	آرنيذيليو
arnedo	آرنيذو
arnes	آرنيس
arnoya	آرنويا
arnuero	آرنويرو
aroche	آروچه
aroizu	آرويثو
arona	آرونا
arquillos	آرکيليوس
arrabalde	آراوالده
arrancacepas	آرانکاثيپاس
arrazola	آراثولا
arrecife	آريثيفه
arredondo	آريذوندو
arriate	آرياته
arrieta	آريتا
arrigorriaga	آريغورياغا
arriondas	آريونداس
arroba	آرووا
arroniz	آرونيث
arroyal	آرويال
arroyos	آرويوس
arta	آرتا
artajona	آرتاخونا
artana	آرتانا
artazu	آرتاثو
arteijo	آرتييخو
artenara	آرتينارا
artes	آرتيس
artieda	آرتيذا
arties	آرتيس
arucas	آروکاس
arure	آروره
arzúa	آرثوا
asco	آسکو
asin	آسين
asomadilla	آسوماذيليا
ason	آسون
aspariegos	آسپاريغوس
aspe	آسپه
astillero	آستيليرو
astudillo	آستوذيليو
asturianos	آستوريانوس
asturias	آستورياس
atalaya	آتالايا
atalayasa	آتالاياسا
ataquines	آتاکينيس
atarfe	آتارفه
atauta	آتاوتا
atea	آتيا
ateca	آتيکا
atienza	آتينثا
atocha	آتوچا
auñón	آونون
ausejo	آوسيخو
autol	آوتول
autoria	آوتوريا
aveinte	آويينته
avellanes	آويليانيس
avila	آويلا
aviles	آويليس
avinyo	آوينيو
avinyonet	آوينيونيت
avion	آويون
ayamonte	آيامونته
ayedo	آيذو
ayllon	آيليون
ayna	آينا
ayora	آيورا
aytona	آيتونا
azagra	آثاغرا
azaila	آثايلا
azañón	آثانون
azanuy	آثانوي
azcoitia	آثکويتيا
aznalcazar	آثنالکاثار
aznalcollar	آثنالکوليار
azpeitia	آثپييتيا
azuaga	آثواغا
azuara	آثوارا
azuelo	آثويلو
babilafuente	باويلافوينته
bacares	باکاريس
badajoz	باذاخوث
badalona	باذالونا
badaran	باذاران
badenas	باذيناس
badolatosa	باذولاتوسا
badules	باذوليس
baena	باينا
baeza	بايثا
baga	باغا
baguena	باغينا
bagur	باغور
bahillo	باايليو
bailen	بايلين
baillo	بايليو
bajamar	باخامار
balaguer	بالاغير
balazote	بالاثوته
balces	بالثيس
balconete	بالکونيته
baleira	بالييرا
balerma	باليرما
balimbra	باليمبرا
balira	باليرا
ballerias	باليرياس
ballestar	باليستار
ballesteros	باليستيروس
ballobar	باليووار
balsareny	بالساريني
balsicas	بالسيکاس
baltanas	بالتاناس
baltar	بالتار
bañares	باناريس
bande	بانده
bañeras	بانيراس
bañobarez	بانوواريث
bañolas	بانولاس
bañon	بانون
banyoles	بانيوليس
banyos	بانيوس
baracaldo	باراکالدو
barahona	بارااونا
barajas	باراخاس
baralla	باراليا
barambio	بارامبيو
barasoain	باراسواين
barbadanes	بارواذانيس
barbadillo	بارواذيليو
barbalimpia	بارواليمپيا
barbastro	بارواسترو
barca	بارکا
barcarrota	بارکاروتا
barcena	بارثينا
barcheta	بارچيتا
barcience	بارثينثه
barcones	بارکونيس
bareyo	بارييو
bargas	بارغاس
barjos	بارخوس
barqueros	بارکيروس
barracas	باراکاس
barrachina	باراچينا
barraco	باراکو
barrax	باراکس
barreiros	بارييروس
barriomartin	باريومارتين
barro	بارو
barruecopardo	بارويکوپارذو
barzana	بارثانا
basauri	باساوري
bascara	باسکارا
basella	باسيليا
batea	باتيا
baterno	باتيرنو
bayo	بايو
bayona	بايونا
baza	باثا
beade	بياذه
beariz	بياريث
beas	بياس
becarrea	بيکاريا
beceite	بيثييته
bechi	بيچي
bedar	بيذار
bedmar	بيذمار
begijar	بيخيخار
begonte	بيغونته
beire	بييره
beires	بييريس
bejar	بيخار
bejis	بيخيس
belchite	بيلچيته
belianes	بيليانيس
belinchón	بيلينچون
bello	بيليو
belltall	بيليتالي
bellver	بيليوير
bellvey	بيليويي
bellvis	بيليويس
belmez	بيلميث
belmonte	بيلمونته
belmontejo	بيلمونتيخو
belorado	بيلوراذو
belver	بيلوير
bembibre	بيمبيوره
benabarre	بيناواره
benacazon	بيناکاثون
benafigos	بينافيغوس
benagalbon	بيناغالوون
benaguacil	بيناغواثيل
benahadux	بيناآذوکس
benahavis	بيناآويس
benajarafa	بيناخارافا
benalauria	بينالاوريا
benamaurel	بيناماوريل
benameji	بيناميخي
benamocarra	بيناموکارا
benaocaz	بيناوکاث
benaojan	بيناوخان
benarraba	بيناراوا
benasal	بيناسال
benasque	بيناسکه
benatae	بيناتاه
benavente	بيناوينته
benavides	بيناويذيس
benavites	بيناويتيس
benegiles	بينيخيليس
benejama	بينيخاما
benejuzar	بينيخوثار
benferri	بينفيري
beniarda	بينيارذا
beniarres	بينياريس
benicasim	بينيکاسيم
benichembla	بينيچيمبلا
benifallet	بينيفاليت
benifallim	بينيفاليم
benifayo	بينيفايو
beniganim	بينيغانيم
benilloba	بينيليووا
benimasot	بينيماسوت
beninar	بينينار
beniopa	بينيوپا
benisa	بينيسا
benisanet	بينيسانيت
beniseno	بينيسينو
benitachell	بينيتاچيلي
benizalon	بينيثالون
benuza	بينوثا
benzu	بينثو
beranga	بيرانگا
berantevilla	بيرانتيويليا
bercedo	بيرثيذو
bercero	بيرثيرو
berducedo	بيرذوثيذو
berdun	بيرذون
berga	بيرغا
bergasa	بيرغاسا
bergondo	بيرغوندو
bergüenda	بيرغويندا
berja	بيرخا
berlanga	بيرلانگا
bermeo	بيرميو
berriz	بيريث
berrocal	بيروکال
berzocana	بيرثوکانا
besalu	بيسالو
besaya	بيسايا
bescane	بيسکانه
betancuria	بيتانکوريا
betanzos	بيتانثوس
betelu	بيتيلو
betera	بيتيرا
beteta	بيتيتا
bezes	بيثيس
biar	بيار
bibey	بيويي
biel	بيل
bielsa	بيلسا
bienvenida	بينبينيذا
biescas	بيسکاس
bigastro	بيغاسترو
biguezal	بيغيثال
bimeda	بيميذا
bimenes	بيمينيس
binaced	بيناثيذ
binefar	بينيفار
binies	بينيس
binisalem	بينيساليم
binue	بينوه
biosca	بيوسکا
biota	بيوتا
biscarrues	بيسکارويس
biurrun	بيورون
bizberri	بيثويري
blanca	بلانکا
blancas	بلانکاس
blancos	بلانکوس
blanes	بلانيس
blanquilla	بلانکيليا
blazques	بلاثکيس
blecua	بليکوا
blesa	بليسا
boada	بواذا
boadilla	بواذيليا
boal	بوال
bobadilla	بوواذيليا
boboras	بووراس
bocairente	بوکايرينته
boceguillas	بوثيغيلياس
bocigas	بوثيغاس
boecillo	بويثيليو
bogarra	بوغارا
bogarre	بوغاره
bohoyo	بواويو
boimorto	بويمورتو
bojar	بوخار
bolaños	بولانوس
bolea	بوليا
boltaña	بولتانا
bonanza	بونانثا
boñar	بونار
bonares	بوناريس
boniches	بونيچيس
bonilla	بونيليا
boqueijon	بوکييخون
bordon	بورذون
borines	بورينيس
borja	بورخا
bornoba	بورنووا
bornos	بورنوس
borobia	بوروويا
borox	بوروکس
borres	بوريس
borriol	بوريول
bosost	بوسوست
bot	بوت
botorrita	بوتوريتا
boveda	بوويذا
brabatas	براواتاس
brañosera	برانوسيرا
braojos	براوخوس
brea	بريا
breda	بريذا
brenes	برينيس
bretun	بريتون
brihuega	برياويغا
briñas	بريناس
brion	بريون
briones	بريونيس
briviesca	بريويسکا
bronchales	برونچاليس
broto	بروتو
brozas	بروثاس
brunete	برونيته
brunola	برونولا
buciegas	بوثيغاس
budia	بوذيا
buena	بوينا
buenavista	بويناويستا
buendia	بوينديا
bueu	بويو
bufali	بوفالي
bugarra	بوغارا
buger	بوخير
buitre	بويتره
bujalance	بوخالانثه
bujan	بوخان
bujaraloz	بوخارالوث
bullas	بولياس
buñero	بونيرو
buniel	بونيل
buñol	بونول
buñola	بونولا
buñuel	بونويل
burbaguena	بورواغينا
bures	بوريس
burgo	بورغو
burgohondo	بورغواوندو
burgos	بورغوس
burguete	بورغيته
burgui	بورغي
burguillos	بورغيليوس
buron	بورون
burriana	بوريانا
burujon	بوروخون
busot	بوسوت
busquistar	بوسکيستار
cabana	کاوانا
cabañaquinta	کاواناکينتا
cabañas	کاواناس
cabanes	کاوانيس
cabanillas	کاوانيلياس
cabe	کاوه
cabezamesada	کاويثاميساذا
cabezarados	کاويثاراذوس
cabezo	کاويثو
cabolafuente	کاوولافوينته
cabra	کاورا
cabrales	کاوراليس
cabranes	کاورانيس
cabreiros	کاورييروس
cabrillanes	کاوريليانيس
cabrillas	کاوريلياس
cacabelos	کاکاويلوس
caceres	کاثيريس
cachilla	کاچيليا
cachorrilla	کاچوريليا
cacin	کاثين
cadagua	کاذاغوا
cadaques	کاذاکيس
cadavedo	کاذاويذو
cadi	کاذي
cadiar	کاذيار
cadreita	کاذرييتا
cadrete	کاذريته
cala	کالا
calaceite	کالاثييته
calaf	کالاف
calafell	کالافيلي
calahorra	کالااورا
calamocha	کالاموچا
calamonte	کالامونته
calañas	کالاناس
calanda	کالاندا
calasparra	کالاسپارا
calatanazor	کالاتاناثور
calatayud	کالاتايوذ
calatorao	کالاتوراو
calaveruela	کالاويرويلا
caldas	کالداس
calderina	کالديرينا
caleruega	کاليرويغا
caleta	کاليتا
calicasas	کاليکاساس
calig	کاليغ
callejas	کاليخاس
calonge	کالونخه
calpe	کالپه
caltojar	کالتوخار
calvia	کالويا
calzadilla	کالثاذيليا
camaleno	کامالينو
camallera	کاماليرا
camarao	کاماراو
camarasa	کاماراسا
camarena	کامارينا
camarillas	کاماريلياس
camariñas	کاماريناس
camas	کاماس
cambados	کامباذوس
cambil	کامبيل
cambre	کامبره
cambrils	کامبريلس
caminomorisco	کامينوموريسکو
caminreal	کامينريال
campanario	کامپاناريو
campanet	کامپانيت
campanillas	کامپانيلياس
campano	کامپانو
campaspero	کامپاسپيرو
campdevanol	کامپذيوانول
campello	کامپيليو
campillo	کامپيليو
campillos	کامپيليوس
campisabalos	کامپيساوالوس
campomanes	کامپومانيس
camporredondo	کامپوريذوندو
camporrells	کامپوريليس
camporrobles	کامپورووليس
campos	کامپوس
campotejar	کامپوتيخار
camprodor	کامپروذور
camprovin	کامپرووين
camunas	کاموناس
cañada	کاناذا
cañadajuncosa	کاناذاخونکوسا
canales	کاناليس
canals	کانالس
cañamares	کاناماريس
cañamero	کاناميرو
cañar	کانار
cañaveral	کاناويرال
cañaveras	کاناويراس
cancarix	کانکاريکس
cancienes	کانثينيس
candas	کانداس
candasnos	کانداسنوس
candelaria	کانديلاريا
candelario	کانديلاريو
candeleda	کانديليذا
candilichera	کانديليچيرا
candin	کاندين
canedo	کانيذو
canena	کانينا
canero	کانيرو
canfranc	کانفرانک
cangas	کانگاس
caniles	کانيليس
canillas	کانيلياس
canizal	کانيثال
canizares	کانيثاريس
canizo	کانيثو
canjayar	کانخايار
cantalapiedra	کانتالاپيذرا
cantalejo	کانتاليخو
cantalojas	کانتالوخاس
cantalpino	کانتالپينو
cantareros	کانتاريروس
cantavieja	کانتاويخا
canteras	کانتيراس
cantillana	کانتيليانا
cantoral	کانتورال
cantoria	کانتوريا
canyellas	کانيلياس
caparroso	کاپاروسو
capdella	کاپذيليا
capdepera	کاپذيپيرا
capellades	کاپيلياذيس
capilduy	کاپيلدوي
capilla	کاپيليا
carabaña	کاراوانا
carabanchel	کاراوانچيل
caracuel	کاراکويل
caralps	کارالپس
caravaca	کاراواکا
carbajo	کارواخو
carbia	کارويا
carcaboso	کارکاووسو
carcabuey	کارکاوويي
carcagente	کارکاخينته
carcar	کارکار
carcastillo	کارکاستيليو
carcelen	کارثيلين
carchel	کارچيل
carchelejo	کارچيليخو
cardejon	کارذيخون
cardona	کارذونا
carenas	کاريناس
cariñena	کارينينا
cariño	کارينو
carlet	کارليت
carmena	کارمينا
carracedelo	کاراثيذيلو
carral	کارال
carranque	کارانکه
carranza	کارانثا
carrascalejo	کاراسکاليخو
carrascosa	کاراسکوسا
carratraca	کاراتراکا
carreña	کارينا
carril	کاريل
carrizal	کاريثال
carrizo	کاريثو
carrizosa	کاريثوسا
carrocera	کاروثيرا
carroo	کاروو
cartama	کارتاما
cartaya	کارتايا
cartelle	کارتيله
carucedo	کاروثيذو
casalarreina	کاسالاريينا
casar	کاسار
casarabonela	کاساراوونيلا
casarejos	کاساريخوس
casares	کاساريس
casariche	کاساريچه
casasimarro	کاساسيمارو
casatejada	کاساتيخاذا
casavieja	کاساويخا
cascante	کاسکانته
caseda	کاسيذا
caseras	کاسيراس
caserras	کاسيراس
casinos	کاسينوس
caso	کاسو
caspe	کاسپه
castala	کاستالا
castalla	کاستاليا
castanesa	کاستانيسا
castaño	کاستانو
castaras	کاستاراس
castejon	کاستيخون
castelflorite	کاستيلفلوريته
castellanos	کاستيليانوس
castelldans	کاستيليدانس
castelldefels	کاستيليديفيلس
castellote	کاستيليوته
castells	کاستيليس
castelltallat	کاستيليتاليات
castellvell	کاستيليويلي
castelseras	کاستيلسيراس
castelvispal	کاستيلويسپال
castielfabib	کاستيلفاويو
castildelgado	کاستيلديلغاذو
castiliscar	کاستيليسکار
castilla	کاستيليا
castillejar	کاستيليخار
castilmimbre	کاستيلميمبره
castilnuevo	کاستيلنويوو
castralvo	کاسترالوو
castril	کاستريل
castrillon	کاستريليون
castrocalion	کاستروکاليون
castrocontrigo	کاستروکونتريغو
castrodeza	کاستروذيثا
castrogeriz	کاستروخيريث
castrogonzalo	کاستروغونثالو
castromocho	کاستروموچو
castromonte	کاسترومونته
castromudarra	کاستروموذارا
castronuevo	کاسترونويوو
castronuño	کاسترونونو
castropodame	کاستروپوذامه
castropol	کاستروپول
castuera	کاستويرا
catadau	کاتاذاو
catarroja	کاتاروخا
cati	کاتي
catllal	کاتليال
catoira	کاتويرا
catoute	کاتووته
catral	کاترال
caude	کاوذه
caudete	کاوذيته
caudiel	کاوذيل
caurel	کاوريل
cavezon	کاويثون
cayon	کايون
cazalegas	کاثاليغاس
cea	ثيا
ceadea	ثياذيا
ceanuri	ثيانوري
cebanico	ثيوانيکو
cebolla	ثيووليا
cebollar	ثيووليار
cebollera	ثيووليرا
cebreros	ثيوريروس
cebron	ثيورون
ceclavin	ثيکلاوين
cecos	ثيکوس
cedeira	ثيذييرا
cedillo	ثيذيليو
cedrillas	ثيذريلياس
cee	ثيه
cehegin	ثيايخين
ceinos	ثيينوس
cejo	ثيخو
celadas	ثيلاذاس
celanova	ثيلانووا
cella	ثيليا
celtiberia	ثيلتيويريا
cenia	ثينيا
cenicero	ثينيثيرو
cenicientos	ثينيثينتوس
cenizate	ثينيثاته
cenlle	ثينله
centellas	ثينتيلياس
centenillo	ثينتينيليو
centro	ثينترو
cepeda	ثيپيذا
cerceda	ثيرثيذا
cercedilla	ثيرثيذيليا
cerda	ثيرذا
cerdedo	ثيرذيذو
cerdido	ثيرذيذو
cerezo	ثيريثو
cernegula	ثيرنيغولا
cerollera	ثيروليرا
cerralbo	ثيرالوو
cervera	ثيرويرا
cespedossa	ثيسپيذوسا
cestona	ثيستونا
cesuras	ثيسوراس
cetina	ثيتينا
ceuti	ثيوتي
chamartin	چامارتين
chamberi	چامبيري
chantada	چانتاذا
chapineria	چاپينيريا
charches	چارچيس
chauchina	چاوچينا
chavaler	چاوالير
checa	چيکا
cheles	چيليس
chella	چيليا
chelva	چيلوا
chera	چيرا
chercos	چيرکوس
chert	چيرت
cherta	چيرتا
cheste	چيسته
chiclana	چيکلانا
chilches	چيلچيس
chilizarrias	چيليثارياس
chillon	چيليون
chiloeches	چيلويچيس
chimerraes	چيميرايس
chinchon	چينچون
chío	چيو
chipiona	چيپيونا
chiprana	چيپرانا
chirivel	چيريويل
chiva	چيوا
chodos	چوذوس
chovar	چووار
chueca	چويکا
chulilla	چوليليا
chullo	چوليو
ciadoncha	ثياذونچا
cibea	ثيويا
cidad	ثيذاذ
cidones	ثيذونيس
ciempozuelos	ثيمپوثويلوس
cieza	ثيثا
cifuentes	ثيفوينتيس
cigales	ثيغاليس
cigüenza	ثيغوينثا
cillamayor	ثيليامايور
cillas	ثيلياس
cilleros	ثيليروس
cimballa	ثيمباليا
cinctorres	ثينکتوريس
cintruenigo	ثينتروينيغو
cional	ثيونال
ciordia	ثيورذيا
ciperez	ثيپيريث
cirat	ثيرات
cirauqui	ثيراوکي
ciria	ثيريا
ciriza	ثيريثا
ciruelos	ثيرويلوس
cirugeda	ثيروخيذا
cisla	ثيسلا
cisneros	ثيسنيروس
cistierna	ثيستيرنا
ciudadela	ثيوذاذيلا
ciutadilla	ثيوتاذيليا
clariana	کلاريانا
coaña	کوانا
cobatillas	کوواتيلياس
cobdar	کووذار
cobeta	کوويتا
cobreros	کووريروس
coca	کوکا
cocentaina	کوثينتاينا
codeseda	کوذيسيذا
codos	کوذوس
cofete	کوفيته
cogollos	کوغوليوس
cogolludo	کوغوليوذو
coín	کوين
coiros	کويروس
coles	کوليس
colgadizos	کولغاذيثوس
colindres	کوليندريس
collados	کولياذوس
collanzo	کوليانثو
colliga	کوليغا
colmenar	کولمينار
colmenarejo	کولميناريخو
colomera	کولوميرا
colunga	کولونگا
comares	کوماريس
combarros	کومباروس
comillas	کوميلياس
competa	کومپيتا
compostela	کومپوستيلا
concud	کونکوذ
conil	کونيل
conjo	کونخو
conques	کونکيس
conquista	کونکيستا
consuegra	کونسويغرا
contes	کونتيس
copons	کوپونس
corbaton	کورواتون
corbelle	کورويله
corbera	کورويرا
corchuela	کورچويلا
corconte	کورکونته
corcubion	کورکوويون
cordoba	کورذووا
cordova	کورذووا
cordovin	کورذووين
corella	کوريليا
coreses	کوريسيس
corgo	کورغو
coria	کوريا
coripe	کوريپه
coristanco	کوريستانکو
corme	کورمه
cornago	کورناغو
corpa	کورپا
corralejo	کوراليخو
corrales	کوراليس
corredoiras	کوريذويراس
corrubedo	کوروويذو
cortegada	کورتيغاذا
cortegana	کورتيغانا
cortelazor	کورتيلاثور
cortes	کورتيس
corullon	کوروليون
corvera	کورويرا
cosa	کوسا
coscurita	کوسکوريتا
coslada	کوسلاذا
cospeito	کوسپييتو
costitx	کوستيچ
cosvenda	کوسويندا
cotiella	کوتيليا
cotillas	کوتيلياس
cotillo	کوتيليو
cotobad	کوتوواذ
cousa	کووسا
covadonga	کوواذونگا
covarrubias	کووارووياس
covas	کوواس
covelo	کوويلو
cox	کوکس
cozar	کوثار
creciente	کريثينته
cremenes	کريمينيس
crespos	کريسپوس
cretas	کريتاس
crevillente	کريويلينته
cripan	کريپان
cristobal	کريستووال
cruce	کروثه
cuadros	کواذروس
cualedro	کواليذرو
cuatretonda	کواتريتوندا
cubells	کوويليس
cubla	کوولا
cucutas	کوکوتاس
cudillero	کوذيليرو
cuellar	کويليار
cuenca	کوينکا
culla	کوليا
cullera	کوليرا
culleredo	کوليريذو
cuntis	کونتيس
curueña	کوروينا
daimiel	دايميل
dalias	دالياس
dancharinea	دانچارينيا
darnius	دارنيوس
daroca	داروکا
darrical	داريکال
darro	دارو
degaña	ديغانا
deifontes	دييفونتيس
deleitosa	ديلييتوسا
delicias	ديليثياس
denia	دينيا
destriana	ديستريانا
deusto	ديوستو
deva	ديوا
deya	دييا
deza	ديثا
dicastillo	ديکاستيليو
diezma	ديثما
dilar	ديلار
dima	ديما
diustes	ديوستيس
dobro	دوورو
dodro	دوذرو
dolar	دولار
dolores	دولوريس
domeno	دومينو
domingo	دومينگو
donado	دوناذو
dosbarrios	دوسواريوس
dozon	دوثون
driebes	دريويس
dueñas	دويناس
dumbria	دومبريا
durango	دورانگو
duraton	دوراتون
durcal	دورکال
ea	ايا
echalar	ايچالار
echalecu	ايچاليکو
echano	ايچانو
echarri	ايچاري
ecija	ايثيخا
egues	ايغيس
eibar	اييوار
ejulve	ايخولوه
elanchove	ايلانچووه
elche	ايلچه
elda	ايلدا
elgoibar	ايلغويوار
elizondo	ايليثوندو
eljas	ايلخاس
elorrio	ايلوريو
embid	ايمبيذ
embun	ايمبون
empanadas	ايمپاناذاس
encinas	اينثيناس
encinasola	اينثيناسولا
encinedo	اينثينيذو
encinillas	اينثينيلياس
enciso	اينثيسو
endrinal	ايندرينال
enfesta	اينفيستا
enguera	اينگيرا
enguidanos	اينگيذانوس
enix	اينيکس
entrena	اينترينا
entrimo	اينتريمو
enveija	اينبييخا
epila	ايپيلا
erice	ايريثه
erillas	ايريلياس
eriste	ايريسته
erla	ايرلا
ermua	ايرموا
errazu	ايراثو
erro	ايرو
erustes	ايروستيس
escairon	ايسکايرون
escalada	ايسکالاذا
escalante	ايسکالانته
escalo	ايسکالو
escalona	ايسکالونا
escalonilla	ايسکالونيليا
escamilla	ايسکاميليا
escanuela	ايسکانويلا
escarroz	ايسکاروث
escatron	ايسکاترون
esclavitud	ايسکلاويتوذ
escombreas	ايسکومبرياس
escorca	ايسکورکا
escoriaza	ايسکورياثا
escorihuela	ايسکورياويلا
escriche	ايسکريچه
escucha	ايسکوچا
escullar	ايسکوليار
escurial	ايسکوريال
escusa	ايسکوسا
escuzar	ايسکوثار
esfiliana	ايسفيليانا
esgos	ايسغوس
espadan	ايسپاذان
espadaña	ايسپاذانا
espadañedo	ايسپاذانيذو
espadilla	ايسپاذيليا
esparragalejo	ايسپاراغاليخو
esparraguera	ايسپاراغيرا
espasante	ايسپاسانته
espeja	ايسپيخا
espejo	ايسپيخو
espeluy	ايسپيلوي
espera	ايسپيرا
espes	ايسپيس
espiel	ايسپيل
espigüete	ايسپيغويته
espin	ايسپين
espina	ايسپينا
espinama	ايسپيناما
espinilla	ايسپينيليا
espirdo	ايسپيرذو
esplegares	ايسپليغاريس
esplugas	ايسپلوغاس
esplus	ايسپلوس
espolla	ايسپوليا
espot	ايسپوت
esquivias	ايسکيوياس
establiments	ايستاوليمينتس
estadilla	ايستاذيليا
estallo	ايستاليو
estanyol	ايستانيول
esteban	ايستيوان
estella	ايستيليا
estena	ايستينا
estepa	ايستيپا
estepar	ايستيپار
estepona	ايستيپونا
estivella	ايستيويليا
estopiñan	ايستوپينان
estremera	ايستريميرا
etreros	ايتريروس
eulate	ايولاته
extremadura	ايستريماذورا
ezcaray	ايثکاراي
ezcurra	ايثکورا
fabara	فاوارا
fabero	فاويرو
facinas	فاثيناس
falces	فالثيس
falconera	فالکونيرا
falset	فالسيت
famorca	فامورکا
fañanas	فاناناس
fanlo	فانلو
farajan	فاراخان
farasdues	فاراسذويس
farena	فارينا
fariza	فاريثا
fatarella	فاتاريليا
faura	فاورا
favareta	فاواريتا
fayon	فايون
febro	فيورو
felanitx	فيلانيچ
felechosa	فيليچوسا
felix	فيليکس
fene	فينه
feria	فيريا
fermoselle	فيرموسيله
fernancaballero	فيرنانکاواليرو
ferreira	فيرييرا
ferrerias	فيريرياس
ferreruela	فيريرويلا
figols	فيغولس
figueras	فيغيراس
figueroles	فيغيروليس
figuerosa	فيغيروسا
finana	فينانا
finestrat	فينيسترات
finisterre	فينيستيره
fiscal	فيسکال
fitero	فيتيرو
flassa	فلاسا
flix	فليکس
fondon	فوندون
fonelas	فونيلاس
fonfria	فونفريا
fonollosa	فونوليوسا
fonsagrada	فونساغراذا
fontanar	فونتانار
fontanarejo	فونتاناريخو
fontanosas	فونتانوساس
fontao	فونتاو
fontellas	فونتيلياس
fontioso	فونتيوسو
fontiveros	فونتيويروس
fontllonga	فونتليونگا
fonz	فونث
forcarey	فورکاريي
foronda	فوروندا
forua	فوروا
foz	فوث
frades	فراذيس
fraga	فراغا
frailes	فرايليس
francos	فرانکوس
frechilla	فريچيليا
fredes	فريذيس
freginals	فريخينالس
freila	فرييلا
fresnedilla	فريسنيذيليا
fresnedo	فريسنيذو
frias	فرياس
frigiliana	فريخيليانا
friol	فريول
fromista	فروميستا
frumales	فروماليس
fuencaliente	فوينکالينته
fuencarral	فوينکارال
fuencemillan	فوينثيميليان
fuendejalon	فوينديخالون
fuendetodos	فوينديتوذوس
fuenferrada	فوينفيراذا
fuengirola	فوينخيرولا
fuenlabrada	فوينلاوراذا
fuenllana	فوينليانا
fuenmayor	فوينمايور
fuensalida	فوينساليذا
fuensanta	فوينسانتا
fuentealbilla	فوينتيالويليا
fuenteboa	فوينتيووا
fuentecen	فوينتيثين
fuenteguinaldo	فوينتيغينالدو
fuenteheridos	فوينتيايريذوس
fuentelapeña	فوينتيلاپينا
fuentelcesped	فوينتيلثيسپيذ
fuentelmonje	فوينتيلمونخه
fuentelsaz	فوينتيلساث
fuentemilanos	فوينتيميلانوس
fuentenovilla	فوينتينوويليا
fuentepelayo	فوينتيپيلايو
fuentepinilla	فوينتيپينيليا
fuenterrabia	فوينتيراويا
fuenterrebollo	فوينتيريووليو
fuenterrobles	فوينتيرووليس
fuentes	فوينتيس
fuentesaúco	فوينتيساوکو
fuentescusa	فوينتيسکوسا
fuentesecas	فوينتيسيکاس
fuentespalda	فوينتيسپالدا
fuentespina	فوينتيسپينا
fuentidueña	فوينتيذوينا
funes	فونيس
furnas	فورناس
fustiñana	فوستينانا
gabaldon	گاوالدون
gabarret	گاواريت
gabasa	گاواسا
gador	گاذور
gajanejos	گاخانيخوس
gajates	گاخاتيس
galapagar	گالاپاغار
galapagos	گالاپاغوس
galar	گالار
galaroza	گالاروثا
galbarra	گالوارا
galdacano	گالداکانو
galdames	گالداميس
galende	گالينده
galera	گاليرا
galicia	گاليثيا
galinduste	گاليندوسته
galisteo	گاليستيو
gallegos	گاليغوس
gallinal	گالينال
gallur	گاليور
galvez	گالويث
gamonal	گامونال
ganame	گانامه
gandesa	گانديسا
gandia	گانديا
ganuelas	گانويلاس
garaballa	گاراواليا
garayoa	گارايوا
garcillan	گارثيليان
gargaligas	گارغاليغاس
gargallo	گارغاليو
gargüera	گارغويرا
garinoain	گارينواين
garoiez	گارويث
garraf	گاراف
garralda	گارالدا
garray	گاراي
garrigas	گاريغاس
garrovillas	گاروويلياس
garrucha	گاروچا
gascueña	گاسکوينا
gata	گاتا
gatova	گاتووا
gaucin	گاوثين
gauna	گاونا
gava	گاوا
gavanes	گاوانيس
gelida	خيليذا
gelsa	خيلسا
gelves	خيلويس
genalguacil	خينالغواثيل
genave	خيناوه
genevilla	خينيويليا
gerena	خيرينا
germade	خيرماذه
gerona	خيرونا
gerri	خيري
gesera	خيسيرا
geve	خيوه
gibarroyo	خيوارويو
gijon	خيخون
gilena	خيلينا
gimenells	خيمينيليس
gironella	خيرونيليا
godall	گوذالي
godelleta	گوذيليتا
goiriz	گويريث
goizueta	گويثويتا
golada	گولاذا
golpejas	گولپيخاس
gomara	گومارا
gomecello	گوميثيليو
gomesende	گوميسينده
gondomar	گوندومار
gor	گور
gorafe	گورافه
gormaz	گورماث
gotarrendura	گوتاريندورا
gozon	گوثون
gradefes	گراذيفيس
grado	گراذو
grajera	گراخيرا
granada	گراناذا
granadella	گراناذيليا
granadilla	گراناذيليا
granatula	گراناتولا
grandes	گرانديس
grañén	گرانين
granollers	گرانوليرس
graus	گراوس
gravalos	گراوالوس
grazalema	گراثاليما
griegos	گريغوس
griñón	گرينون
grisen	گريسين
grove	گرووه
guadahortuna	گواذااورتونا
guadajoz	گواذاخوث
guadalajara	گواذالاخارا
guadalaviar	گواذالاويار
guadalcanal	گواذالکانال
guadalcazar	گواذالکاثار
guadalupe	گواذالوپه
guadamur	گواذامور
guadarrama	گواذاراما
guadarranque	گواذارانکه
guadasuar	گواذاسوار
guadix	گواذيکس
gualchos	گوالچوس
gualta	گوالتا
guardiola	گوارذيولا
guardo	گوارذو
guareña	گوارينا
guaro	گوارو
guarroman	گوارومان
gudar	گوذار
guecho	گيچو
güeñes	گوينيس
güesa	گويسا
guetaria	گيتاريا
guiana	گيانا
guijo	گيخو
guijuelo	گيخويلو
guillarey	گيلياريي
guillena	گيلينا
guillerias	گيليرياس
guimaray	گيماراي
guimera	گيميرا
guisona	گيسونا
guitiriz	گيتيريث
gulina	گولينا
guntin	گونتين
guriezo	گوريثو
gurp	گورپ
hacinas	آثيناس
haro	آرو
hecho	ايچو
helechal	ايليچال
helechosa	ايليچوسا
hellin	ايلين
henarejos	ايناريخوس
henche	اينچه
herbes	ايرويس
herencia	ايرينثيا
hernani	ايرناني
hernansancho	ايرنانسانچو
herramelluri	ايراميليوري
herrera	ايريرا
herreria	ايريريا
herrerias	ايريرياس
herreros	ايريروس
herreruela	ايريرويلا
hervas	ايرواس
higa	ايغا
higuera	ايغيرا
higueruela	ايغيرويلا
higueruelas	ايغيرويلاس
hijar	ايخار
hinodejo	اينوذيخو
hinojal	اينوخال
hinojales	اينوخاليس
hinojares	اينوخاريس
hinojos	اينوخوس
hinojosa	اينوخوسا
hinojosas	اينوخوساس
holguera	اولغيرا
hombrados	اومبراذوس
honrubia	اونروويا
hontalbilla	اونتالويليا
hontanares	اونتاناريس
hontanaya	اونتانايا
hontecillos	اونتيثيليوس
hontoba	اونتووا
horche	اورچه
hornos	اورنوس
hospitalet	اوسپيتاليت
hoyos	اويوس
hoyuelos	اويويلوس
huarte	اوارته
huelago	اويلاغو
huelamo	اويلامو
huelma	اويلما
huelva	اويلوا
huelves	اويلويس
hueneja	اوينيخا
huermeces	اويرميثيس
huerrios	اويريوس
huertahernando	اويرتاايرناندو
huerteles	اويرتيليس
huerto	اويرتو
huesa	اويسا
huesca	اويسکا
huescar	اويسکار
huete	اويته
humanes	اومانيس
humilladero	اوميلياذيرو
husillos	اوسيليوس
ibahernando	ايواايرناندو
ibdes	ايوذيس
ibi	ايوي
iborra	ايوورا
ibros	ايوروس
idocin	ايذوثين
iglesias	ايغليسياس
igualada	ايغوالاذا
igualeja	ايغواليخا
igüeña	ايغوينا
ilche	ايلچه
ilerda	ايليرذا
ilipa	ايليپا
illana	ايليانا
illano	ايليانو
illas	ايلياس
illescas	ايليسکاس
illora	ايليورا
illueca	ايليويکا
imon	ايمون
incinillas	اينثينيلياس
incio	اينثيو
infantes	اينفانتيس
infiesto	اينفيستو
iniesta	اينيستا
instincion	اينستينثيون
irijo	ايريخو
irijoa	ايريخوا
irueste	ايرويسته
irun	ايرون
irura	ايرورا
irurita	ايروريتا
irurozqui	ايروروثکي
isaba	ايساوا
iscar	ايسکار
isil	ايسيل
isona	ايسونا
isso	ايسو
istan	ايستان
isuerre	ايسويره
itrabo	ايتراوو
ituero	ايتويرو
izalzu	ايثالثو
izarra	ايثارا
iznájar	ايثناخار
iznalloz	ايثناليوث
iznatoraf	ايثناتوراف
jabaga	خاواغا
jabalera	خاواليرا
jabaloyas	خاوالوياس
jabalquinto	خاوالکينتو
jabarriega	خاواريغا
jabugo	خاووغو
jaca	خاکا
jadraque	خاذراکه
jaen	خاين
jalance	خالانثه
jalon	خالون
jaraba	خاراوا
jaraco	خاراکو
jarafuel	خارافويل
jaraicejo	خارايثيخو
jarandilla	خارانديليا
jaray	خاراي
jarque	خارکه
jatar	خاتار
jatiel	خاتيل
jativa	خاتيوا
jaulin	خاولين
jaurrieta	خاوريتا
javea	خاويا
jayena	خاينا
jemenuño	خيمينونو
jeresa	خيريسا
jerica	خيريکا
jerte	خيرته
jimena	خيمينا
jirueque	خيرويکه
jodar	خوذار
jorairatar	خورايراتار
jorcas	خورکاس
jorquera	خورکيرا
jove	خووه
jubera	خوويرا
jubrique	خووريکه
judes	خوذيس
judio	خوذيو
jumilla	خوميليا
juncajo	خونکاخو
juncosa	خونکوسا
juneda	خونيذا
labacolla	لاواکوليا
labajos	لاواخوس
laborcillas	لاوورثيلياس
lacalahorra	لاکالااورا
lachar	لاچار
lacumbre	لاکومبره
lage	لاخه
laguarres	لاغواريس
laguarta	لاغوارتا
lagunaseca	لاغوناسيکا
lagunilla	لاغونيليا
lalin	لالين
lama	لاما
lanaja	لاناخا
lancara	لانکارا
lanciego	لانثيغو
landete	لانديته
lanestosa	لانيستوسا
langreo	لانگريو
languilla	لانگيليا
lanjaron	لانخارون
lantadilla	لانتاذيليا
lanteira	لانتييرا
lanz	لانث
lanza	لانثا
lapeza	لاپيثا
lardero	لارذيرو
laredo	لاريذو
laroco	لاروکو
laroles	لاروليس
larrainzar	لاراينثار
larraona	لاراونا
larrion	لاريون
lasarte	لاسارته
latina	لاتينا
latre	لاتره
lavadores	لاواذوريس
lavapiés	لاواپيس
layana	لايانا
layna	لاينا
layos	لايوس
laza	لاثا
leache	لياچه
lebrija	ليوريخا
lecera	ليثيرا
leciñena	ليثينينا
lecumberri	ليکومبيري
ledaña	ليذانا
ledanca	ليذانکا
ledesma	ليذيسما
leganés	ليغانيس
leganiel	ليغانيل
leiro	لييرو
leitariegos	لييتاريغوس
leiza	لييثا
lemona	ليمونا
lences	لينثيس
lepe	ليپه
lequeitio	ليکييتيو
lerga	ليرغا
lerida	ليريذا
lerin	ليرين
lerma	ليرما
les	ليس
lesaca	ليساکا
letur	ليتور
letux	ليتوکس
leza	ليثا
lezama	ليثاما
lezuza	ليثوثا
librilla	ليوريليا
libros	ليوروس
lidon	ليذون
liédena	ليذينا
lietor	ليتور
lijar	ليخار
lillol	ليليول
limpias	ليمپياس
linares	ليناريس
liñola	لينولا
liria	ليريا
lizarraga	ليثاراغا
llado	لياذو
llafranc	ليافرانک
llagostera	لياغوستيرا
llanes	ليانيس
llansa	ليانسا
llauri	لياوري
llera	ليرا
llerena	ليرينا
llers	ليرس
lles	ليس
llivia	ليويا
llobregales	ليووريغاليس
llodio	ليوذيو
llombay	ليومباي
lloseta	ليوسيتا
llovera	ليوويرا
llubi	ليووي
lluchmayor	ليوچمايور
loarre	لواره
lobatejo	لوواتيخو
lobera	لوويرا
lobon	لوون
lodosa	لوذوسا
loeches	لويچيس
logroño	لوغرونو
logrosan	لوغروسان
loja	لوخا
lombrana	لومبرانا
longares	لونگاريس
lopera	لوپيرا
lorca	لورکا
lorcha	لورچا
lorenzana	لورينثانا
lores	لوريس
lorqui	لورکي
losacino	لوساثينو
lousame	لووسامه
lovios	لوويوس
lozoya	لوثويا
lozoyuela	لوثويويلا
luanco	لوانکو
luarca	لوارکا
lubian	لوويان
lubrin	لوورين
lucar	لوکار
lucena	لوثينا
luceni	لوثيني
lucillo	لوثيليو
ludiente	لوذينته
luelmo	لويلمو
luesia	لويسيا
luezas	لويثاس
lugan	لوغان
lugo	لوغو
lugones	لوغونيس
lugros	لوغروس
lujar	لوخار
lumbier	لومبير
lumbrales	لومبراليس
lumbreras	لومبريراس
lumpiaque	لومپياکه
luna	لونا
luque	لوکه
luyego	لويغو
luzaga	لوثاغا
luzon	لوثون
macael	ماکايل
maceda	ماثيذا
machero	ماچيرو
macotera	ماکوتيرا
maderuelo	ماذيرويلو
madridejos	ماذريذيخوس
madrigalejo	ماذريغاليخو
madriguera	ماذريغيرا
madrigueras	ماذريغيراس
madrona	ماذرونا
madronera	ماذرونيرا
madroño	ماذرونو
maella	مايليا
maello	مايليو
maestre	مايستره
maestu	مايستو
magacela	ماغاثيلا
magallon	ماغاليون
magaña	ماغانا
magaz	ماغاث
magina	ماخينا
maguilla	ماغيليا
mahide	ماايذه
mahon	مااون
mahora	مااورا
mainar	ماينار
majadas	ماخاذاس
majaelrayo	ماخايلرايو
mala	مالا
malagon	مالاغون
malaguilla	مالاغيليا
malanquilla	مالانکيليا
malcocinado	مالکوثيناذو
malgrat	مالغرات
mallen	مالين
malon	مالون
malpica	مالپيکا
maluenda	مالويندا
mampodre	مامپوذره
manacor	ماناکور
manchita	مانچيتا
mandayona	ماندايونا
mañeru	مانيرو
manilva	مانيلوا
manises	مانيسيس
manlleu	مانليو
manresa	مانريسا
manresana	مانريسانا
mansilla	مانسيليا
mantañes	مانتانيس
mantiel	مانتيل
manzanares	مانثاناريس
manzaneda	مانثانيذا
manzanedo	مانثانيذو
manzaneque	مانثانيکه
manzanera	مانثانيرا
maqueda	ماکيذا
maracena	ماراثينا
maranchon	مارانچون
marazoleja	ماراثوليخا
marbella	مارويليا
marcilla	مارثيليا
marganell	مارغانيلي
mariana	ماريانا
marin	مارين
marinaleda	ماريناليذا
marines	مارينيس
marmolejo	مارموليخو
marron	مارون
marrube	مارووه
marrupe	ماروپه
martorell	مارتوريلي
martos	مارتوس
marugan	ماروغان
masa	ماسا
masalaves	ماسالاويس
masamagrell	ماساماغريلي
masanasa	ماساناسا
mascaraque	ماسکاراکه
masegoso	ماسيغوسو
maside	ماسيذه
masquefa	ماسکيفا
massanas	ماساناس
matabuena	ماتاووينا
matagalls	ماتاغاليس
matalebreras	ماتاليوريراس
matallana	ماتاليانا
matamorosa	ماتاموروسا
matanza	ماتانثا
matapozuelos	ماتاپوثويلوس
mataro	ماتارو
matarrubia	ماتاروويا
matedeon	ماتيذيون
matienzo	ماتينثو
matute	ماتوته
mausoleo	ماوسوليو
mayalde	مايالده
mayals	مايالس
mayorga	مايورغا
mazarete	ماثاريته
mazaricos	ماثاريکوس
mazarron	ماثارون
mazarulleque	ماثاروليکه
mazateron	ماثاتيرون
mazuecos	ماثويکوس
meano	ميانو
meco	ميکو
mediana	ميذيانا
medina	ميذينا
mediña	ميذينا
medinaceli	ميذيناثيلي
mediodia	ميذيوذيا
mediona	ميذيونا
meijaboy	مييخاووي
meira	مييرا
meis	مييس
mejorada	ميخوراذا
meliana	ميليانا
melida	ميليذا
mellid	ميليذ
melon	ميلون
membrilla	ميمبريليا
membrillar	ميمبريليار
membrillera	ميمبريليرا
membrio	ميمبريو
menasalbas	ميناسالواس
mencal	مينکال
mendavia	مينداويا
mendigorria	مينديغوريا
meneses	مينيسيس
mengabril	مينگاوريل
mengibar	مينخيوار
mentrida	مينتريذا
mequinenza	ميکينينثا
mera	ميرا
merida	ميريذا
mesia	ميسيا
mesones	ميسونيس
mestanza	ميستانثا
miajadas	مياخاذاس
miedes	ميذيس
mieras	ميراس
mieres	ميريس
mieza	ميثا
miguelturra	ميغيلتورا
mijares	ميخاريس
mijas	ميخاس
milagro	ميلاغرو
millana	ميليانا
millares	ميلياريس
millena	ميلينا
minana	مينانا
minateda	ميناتيذا
minaya	مينايا
minglanilla	مينگلانيليا
mingorria	مينگوريا
miño	مينو
mira	ميرا
mirabel	ميراويل
mirambel	ميرامبيل
mirandilla	ميرانديليا
miravalles	ميراواليس
miravet	ميراويت
miravete	ميراويته
moaña	موانا
mocejon	موثيخون
mochales	موچاليس
moclin	موکلين
moeche	مويچه
mofrecho	موفريچو
mogente	موخينته
mogon	موغون
moguer	موغير
mohedas	موايذاس
mohorte	مواورته
mojacar	موخاکار
mojados	موخاذوس
mojina	موخينا
mola	مولا
molaton	مولاتون
molinaseca	موليناسيکا
molinicos	مولينيکوس
molinos	مولينوس
molledo	موليذو
mollerusa	موليروسا
mollet	موليت
mollina	مولينا
mollo	موليو
moluengo	مولوينگو
molvizar	مولويثار
mombeltran	مومبيلتران
mombuey	مومبويي
monachil	موناچيل
monbeltran	مونبيلتران
moncada	مونکاذا
moncalvo	مونکالوو
moncayo	مونکايو
moncloa	مونکلوا
moncofar	مونکوفار
monda	موندا
mondariz	مونداريث
mondejar	مونديخار
mondoñedo	موندونيذو
mondragon	موندراغون
monduber	موندووير
monegrillo	مونيغريليو
monesterio	مونيستيريو
moneva	مونيوا
monfero	مونفيرو
monflorite	مونفلوريته
mongo	مونگو
monistrol	مونيسترول
monleras	مونليراس
monovar	مونووار
monreal	مونريال
monroy	مونروي
monroyo	مونرويو
monsagro	مونساغرو
monserrat	مونسيرات
montalban	مونتالوان
montalbanejo	مونتالوانيخو
montalbo	مونتالوو
montalbos	مونتالووس
montalvos	مونتالووس
montan	مونتان
montanchez	مونتانچيث
montanyola	مونتانيولا
montarto	مونتارتو
monteagudo	مونتياغوذو
montearagon	مونتياراغون
montederramo	مونتيذيرامو
montefrio	مونتيفريو
montejaque	مونتيخاکه
montejicar	مونتيخيکار
montellano	مونتيليانو
montemolin	مونتيمولين
monterrey	مونتيريي
monterroso	مونتيروسو
monterrubio	مونتيروويو
montesa	مونتيسا
montesclaros	مونتيسکلاروس
montiel	مونتيل
montijo	مونتيخو
montilla	مونتيليا
montillana	مونتيليانا
montizon	مونتيثون
montmelo	مونتميلو
monton	مونتون
montoro	مونتورو
montras	مونتراس
montroy	مونتروي
montuenga	مونتوينگا
montuiri	مونتويري
monturque	مونتورکه
monzon	مونثون
mora	مورا
moral	مورال
moraleja	موراليخا
morales	موراليس
moralina	مورالينا
moraña	مورانا
morante	مورانته
moratalla	موراتاليا
morcillo	مورثيليو
moreda	موريذا
morell	موريلي
morella	موريليا
morentin	مورينتين
mores	موريس
morey	موريي
moriles	موريليس
morillejo	موريليخو
morla	مورلا
moros	موروس
mos	موس
mosqueruela	موسکيرويلا
mostoles	موستوليس
motilla	موتيليا
motilleja	موتيليخا
motos	موتوس
motril	موتريل
moya	مويا
moyuela	مويويلا
mozoncillo	موثونثيليو
muchamiel	موچاميل
mucientes	موثينتيس
muel	مويل
mugaire	موغايره
mugardos	موغارذوس
mugia	موخيا
mugica	موخيکا
muiños	موينوس
mula	مولا
muñana	مونانا
munebrega	مونيوريغا
munera	مونيرا
mungia	مونخيا
munico	مونيکو
muniesa	مونيسا
munilla	مونيليا
muñogalindo	مونوغاليندو
muñogrande	مونوغرانده
muntadas	مونتاذاس
muras	موراس
murchante	مورچانته
murcia	مورثيا
murguia	مورغيا
muriel	موريل
muro	مورو
muros	موروس
murtas	مورتاس
murueta	مورويتا
nacimiento	ناثيمينتو
nagore	ناغوره
naharros	ناآروس
najera	ناخيرا
nambroca	نامبروکا
naquera	ناکيرا
narboneta	ناروونيتا
naron	نارون
nava	ناوا
navacerrada	ناواثيراذا
navachica	ناواچيکا
navaconcejo	ناواکونثيخو
navafria	ناوافريا
navahermosa	ناواايرموسا
navahondilla	ناوااونديليا
navajas	ناواخاس
naval	ناوال
navalacruz	ناوالاکروث
navalagamella	ناوالاغاميليا
navalcaballo	ناوالکاواليو
navalcan	ناوالکان
navaleno	ناوالينو
navalguijo	ناوالغيخو
navalilla	ناواليليا
navalmanzano	ناوالمانثانو
navalmoral	ناوالمورال
navalmoralejo	ناوالموراليخو
navalonguilla	ناوالونگيليا
navalosa	ناوالوسا
navalpino	ناوالپينو
navalsauz	ناوالساوث
navaluenga	ناوالوينگا
navardun	ناوارذون
navarres	ناواريس
navarrete	ناواريته
navas	ناواس
navasa	ناواسا
navascues	ناواسکويس
navasfrias	ناواسفرياس
navata	ناواتا
navelgas	ناويلغاس
naves	ناويس
navia	ناويا
nebreda	نيوريذا
neda	نيذا
negredo	نيغريذو
negreira	نيغرييرا
neila	نييلا
nerja	نيرخا
nerpio	نيرپيو
nerva	نيروا
nestar	نيستار
niebla	نيولا
nieves	نيويس
nigran	نيغران
niguelas	نيغيلاس
nijar	نيخار
noain	نواين
noalejo	نواليخو
noblejas	نووليخاس
noceda	نوثيذا
noez	نويث
nofuentes	نوفوينتيس
nogales	نوغاليس
nograles	نوغراليس
noguera	نوغيرا
nogueruelas	نوغيرويلاس
nois	نويس
nolay	نولاي
nombela	نومبيلا
nonaspe	نوناسپه
noreña	نورينا
novales	نوواليس
novallas	نووالياس
novelda	نوويلدا
noves	نوويس
novillas	نوويلياس
noya	نويا
nueno	نوينو
nueva	نويوا
nules	نوليس
nulles	نوليس
numancia	نومانثيا
nuñomoral	نونومورال
obon	اوون
ocaña	اوکانا
ocejon	اوثيخون
ocentejo	اوثينتيخو
ochagavia	اوچاغاويا
ochandiano	اوچانديانو
oden	اوذين
odon	اوذون
ohanes	اوآنيس
oímbra	اويمبرا
ojen	اوخين
ojos	اوخوس
olalla	اولاليا
olave	اولاوه
olazagutia	اولاثاغوتيا
olba	اولوا
oleiros	اولييروس
oliana	اوليانا
olias	اولياس
oliete	اوليته
oliola	اوليولا
olite	اوليته
oliva	اوليوا
olivares	اوليواريس
olivella	اوليويليا
olivenza	اوليوينثا
olleria	اوليريا
ollo	اوليو
olmedillas	اولميذيلياس
olmedo	اولميذو
olmillos	اولميليوس
olocau	اولوکاو
olombrada	اولومبراذا
olost	اولوست
olot	اولوت
olvan	اولوان
olvega	اولويغا
olvena	اولوينا
olvera	اولويرا
olza	اولثا
oña	اونا
oñate	اوناته
oncala	اونکالا
onda	اوندا
ondara	اوندارا
ondarroa	اونداروا
onis	اونيس
ontaneda	اونتانيذا
onteniente	اونتينينته
ontur	اونتور
onzonilla	اونثونيليا
oquillas	اوکيلياس
orbara	اوروارا
orce	اورثه
orcera	اورثيرا
orcheta	اورچيتا
orduña	اورذونا
orea	اوريا
orejo	اوريخو
orense	اورينسه
ores	اوريس
orgaña	اورغانا
orgaz	اورغاث
orgiva	اورخيوا
oria	اوريا
orihuela	اورياويلا
orio	اوريو
oris	اوريس
orista	اوريستا
orle	اورله
orol	اورول
oropesa	اوروپيسا
oroso	اوروسو
orozco	اوروثکو
orrios	اوريوس
orrius	اوريوس
orusco	اوروسکو
osera	اوسيرا
osor	اوسور
osorno	اوسورنو
ostiz	اوستيث
osuna	اوسونا
oteiza	اوتييثا
oteo	اوتيو
otero	اوتيرو
otivar	اوتيوار
otura	اوتورا
oural	اوورال
outes	اووتيس
ouviaño	اوويانو
ovejo	اوويخو
oviedo	اوويذو
oya	اويا
oyarzun	اويارثون
oyon	اويون
ozaeta	اوثايتا
padron	پاذرون
padul	پاذول
paguera	پاغيرا
pajares	پاخاريس
pajaron	پاخارون
pajaroncillo	پاخارونثيليو
palafrugell	پالافروخيلي
palamos	پالاموس
palancas	پالانکاس
palanques	پالانکيس
palanquinos	پالانکينوس
palencia	پالينثيا
palenciana	پالينثيانا
palentino	پالينتينو
palenzuela	پالينثويلا
pallares	پالياريس
pallars	پاليارس
palleja	پاليخا
pallerols	پاليرولس
palma	پالما
palo	پالو
palomas	پالوماس
palomeque	پالوميکه
palomera	پالوميرا
pals	پالس
pampliega	پامپليغا
pamplona	پامپلونا
pancorbo	پانکوروو
pancrudo	پانکروذو
panes	پانيس
paniza	پانيثا
panticosa	پانتيکوسا
pantoja	پانتوخا
panton	پانتون
paones	پاونيس
papeles	پاپيليس
paracuellos	پاراکويليوس
paradas	پاراذاس
paradaseca	پاراذاسيکا
paradela	پاراذيلا
paramo	پارامو
parauta	پاراوتا
parcent	پارثينت
pardilla	پارذيليا
paredes	پاريذيس
pareja	پاريخا
parets	پاريتس
parga	پارغا
parla	پارلا
parlaba	پارلاوا
parres	پاريس
parrillas	پاريلياس
partaloa	پارتالوا
parzan	پارثان
pasajes	پاساخيس
pasaron	پاسارون
pastoriza	پاستوريثا
pastrana	پاسترانا
pauls	پاولس
pavias	پاوياس
paymogo	پايموغو
pechina	پيچينا
pedralba	پيذرالوا
pedralbes	پيذرالويس
pedreguer	پيذريغير
pedrera	پيذريرا
pedroche	پيذروچه
pedrola	پيذرولا
pedroso	پيذروسو
pedrouzos	پيذرووثوس
pegalajar	پيغالاخار
pego	پيغو
pelahustan	پيلااوستان
peleagonzalo	پيلياغونثالو
pelegrina	پيليغرينا
peloche	پيلوچه
peñacerrada	پيناثيراذا
peñafiel	پينافيل
peñaflor	پينافلور
peñagolosa	پيناغولوسا
penagos	پيناغوس
peñalba	پينالوا
peñalen	پينالين
peñarrubia	پيناروويا
peñascosa	پيناسکوسا
peñausende	پيناوسينده
peniscola	پينيسکولا
pepino	پيپينو
peracense	پيراثينسه
perafita	پيرافيتا
peral	پيرال
peralejos	پيراليخوس
peralta	پيرالتا
peraltilla	پيرالتيليا
peralveche	پيرالويچه
peramola	پيرامولا
peranzanes	پيرانثانيس
peratallada	پيراتالياذا
perdiguera	پيرذيغيرا
perelada	پيريلاذا
perello	پيريليو
pereña	پيرينا
pereruela	پيريرويلا
periana	پيريانا
perorrubio	پيروروويو
pertusa	پيرتوسا
perves	پيرويس
pesaguero	پيساغيرو
pescueza	پيسکويثا
pesquera	پيسکيرا
pesues	پيسويس
petin	پيتين
pias	پياس
picacho	پيکاچو
picasent	پيکاسينت
picon	پيکون
picorro	پيکورو
piedrabuena	پيذراووينا
piedrafita	پيذرافيتا
piedrahita	پيذراايتا
piera	پيرا
pilas	پيلاس
piloña	پيلونا
pina	پينا
pinar	پينار
pinarejo	پيناريخو
pinarejos	پيناريخوس
pineda	پينيذا
pinet	پينيت
pinillos	پينيليوس
pinofranqueado	پينوفرانکياذو
piñor	پينور
pinos	پينوس
pinoso	پينوسو
pintano	پينتانو
pipaon	پيپاون
piqueras	پيکيراس
pira	پيرا
pitillas	پيتيلياس
pizarra	پيثارا
pizarral	پيثارال
plan	پلان
planes	پلانيس
plasencia	پلاسينثيا
plasenzuela	پلاسينثويلا
plencia	پلينثيا
pliego	پليغو
plou	پلوو
pobes	پوويس
poblete	پووليته
poboleda	پووليذا
pol	پول
polanco	پولانکو
polenino	پولينينو
polentinos	پولينتينوس
polientes	پولينتيس
pollensa	پولينسا
pollos	پوليوس
polopos	پولوپوس
pomar	پومار
pomer	پومير
ponferrada	پونفيراذا
ponga	پونگا
pons	پونس
pontevedra	پونتيويذرا
pontones	پونتونيس
pontons	پونتونس
ponzano	پونثانو
porcuna	پورکونا
porquera	پورکيرا
porrera	پوريرا
porreras	پوريراس
porriño	پورينو
porron	پورون
portaje	پورتاخه
porto	پورتو
porzuna	پورثونا
posada	پوساذا
posadas	پوساذاس
posadilla	پوساذيليا
potes	پوتيس
povedilla	پوويذيليا
poyales	پوياليس
poyatos	پوياتوس
poyo	پويو
poyos	پويوس
pozaldez	پوثالديث
pozoantiguo	پوثوانتيغوو
pozohondo	پوثواوندو
pozondon	پوثوندون
pozorrubio	پوثوروويو
pozoseco	پوثوسيکو
pozuelo	پوثويلو
pradairo	پراذايرو
pradales	پراذاليس
pradejon	پراذيخون
pradena	پراذينا
prades	پراذيس
pradillo	پراذيليو
prado	پراذو
pradoluengo	پراذولوينگو
pratdip	پراتذيپ
pravia	پراويا
preixens	پرييکسينس
prejano	پريخانو
priego	پريغو
prioro	پريورو
proaza	پرواثا
progalo	پروغالو
pruna	پرونا
puenteareas	پوينتيارياس
puentedeume	پوينتيذيومه
puentenansa	پوينتينانسا
puenteviesgo	پوينتيويسغو
pueyo	پوييو
pujerra	پوخيرا
pulgar	پولغار
pulpi	پولپي
pungin	پونخين
purchena	پورچينا
purujosa	پوروخوسا
purullena	پورولينا
puzol	پوثول
quart	کوارت
quel	کيل
quemada	کيماذا
quero	کيرو
quesa	کيسا
quesada	کيساذا
quintanapalla	کينتاناپاليا
quintanavides	کينتاناويذيس
quintanilla	کينتانيليا
quintela	کينتيلا
quinto	کينتو
quiroga	کيروغا
quiros	کيروس
quisicedo	کيسيثيذو
quismondo	کيسموندو
rabade	راواذه
rabanales	راواناليس
rabasa	راواسا
rabo	راوو
radona	راذونا
rafales	رافاليس
ragama	راغاما
ragol	راغول
rajadell	راخاذيلي
ramacastañas	راماکاستاناس
ramallosa	راماليوسا
rascafria	راسکافريا
rasines	راسينيس
raso	راسو
rasquera	راسکيرا
rasueros	راسويروس
reales	رياليس
rebalsadores	ريوالساذوريس
rebollera	ريووليرا
rebollo	ريووليو
recas	ريکاس
redona	ريذونا
redondela	ريذونديلا
regenjo	ريخينخو
reillo	رييليو
reina	ريينا
reinosa	ريينوسا
relleu	ريليو
rellinas	ريليناس
rena	رينا
renales	ريناليس
renedo	رينيذو
renera	رينيرا
rengos	رينگوس
renteria	رينتيريا
reocin	ريوثين
requejo	ريکيخو
requena	ريکينا
resoba	ريسووا
respaldiza	ريسپالديثا
restiello	ريستيليو
retamal	ريتامال
retamosa	ريتاموسا
retiendas	ريتينداس
reus	ريوس
revillarruz	ريويلياروث
revolcadores	ريوولکاذوريس
riahuelas	ريااويلاس
rialp	ريالپ
rianjo	ريانخو
riaño	ريانو
riaza	رياثا
ribadavia	ريواذاويا
ribadeo	ريواذيو
ribadesella	ريواذيسيليا
ribadumia	ريواذوميا
ribaforada	ريوافوراذا
ribafrecha	ريوافريچا
ribarredonda	ريواريذوندا
ribatajada	ريواتاخاذا
ribesalbes	ريويسالويس
ribota	ريووتا
ricla	ريکلا
ricobayo	ريکووايو
ricote	ريکوته
riello	ريليو
rielves	ريلويس
riglos	ريغلوس
rigoitia	ريغويتيا
rilla	ريليا
riner	رينير
rio	ريو
riobarba	ريوواروا
riocabado	ريوکاواذو
riocaldo	ريوکالدو
riodeva	ريوذيوا
riofrio	ريوفريو
riogordo	ريوغورذو
rioja	ريوخا
riolobos	ريولووس
riopar	ريوپار
rios	ريوس
riosa	ريوسا
riotorto	ريوتورتو
ripoll	ريپولي
ripollet	ريپوليت
risco	ريسکو
riudarenas	ريوذاريناس
riudaura	ريوذاورا
riudecanas	ريوذيکاناس
riudecols	ريوذيکولس
riudoms	ريوذومس
riveira	ريوييرا
rivero	ريويرو
roa	روا
roales	رواليس
robleda	رووليذا
robledo	رووليذو
robledollano	رووليذوليانو
robres	رووريس
rocallaura	روکالياورا
rociana	روثيانا
rodana	روذانا
rodeiro	روذييرو
rodellar	روذيليار
rodenas	روذيناس
rodiezmo	روذيثمو
rodoña	روذونا
rodos	روذوس
rois	رويس
rojales	روخاليس
rollan	روليان
romanones	رومانونيس
roncal	رونکال
roncesvalles	رونثيسواليس
ronda	روندا
roquetas	روکيتاس
rosal	روسال
rosas	روساس
rosell	روسيلي
rota	روتا
rotova	روتووا
royuela	رويويلا
ruanes	روانيس
rubena	رووينا
rubi	رووي
rubiales	رووياليس
rubian	روويان
rubiana	روويانا
rubio	روويو
rubite	روويته
rudilla	روذيليا
rueda	رويذا
ruesta	رويستا
ruguilla	روغيليا
ruidera	رويذيرا
rupia	روپيا
rus	روس
rute	روته
sabadell	ساواذيلي
sabero	ساويرو
sabiñánigo	ساوينانيغو
sabiote	ساويوته
sacañet	ساکانيت
sacedon	ساثيذون
sacedoncillo	ساثيذونثيليو
saceruela	ساثيرويلا
sacramenia	ساکرامينيا
sada	ساذا
sadaba	ساذاوا
saelices	سايليثيس
sagaro	ساغارو
sagides	ساخيذيس
sagra	ساغرا
sagunto	ساغونتو
sahagun	ساآغون
salada	سالاذا
salamanca	سالامانکا
salamon	سالامون
salar	سالار
salardu	سالارذو
salas	سالاس
salce	سالثه
salcedo	سالثيذو
saldaña	سالدانا
saldon	سالدون
salduero	سالدويرو
salinas	ساليناس
salinas	ساليناس
sallent	سالينت
salmeron	سالميرون
salmoral	سالمورال
salobral	سالوورال
salobre	سالووره
salobrena	سالوورينا
salomo	سالومو
salorino	سالورينو
salou	سالوو
salsadella	سالساذيليا
salt	سالت
salvacañete	سالواکانيته
salvatierra	سالواتيرا
samboal	سامبوال
samos	ساموس
sampedor	سامپيذور
samper	سامپير
sanabria	ساناوريا
sanahuja	سانااوخا
sancedo	سانثيذو
sanchidrian	سانچيذريان
sanchonuño	سانچونونو
sandianes	سانديانيس
sando	ساندو
sangenjo	سانخينخو
sangüesa	سانگويسا
sansol	سانسول
santacara	سانتاکارا
santaella	سانتايليا
santany	سانتاني
santibañez	سانتيوانيث
santillana	سانتيليانا
santiso	سانتيسو
santiuste	سانتيوسته
santiz	سانتيث
santolea	سانتوليا
santomera	سانتوميرا
santoña	سانتونا
santovenia	سانتووينيا
santucri	سانتوکري
santurce	سانتورثه
santurde	سانتورذه
sanzoles	سانثوليس
sapeira	ساپييرا
saragossa	ساراغوسا
sariego	ساريغو
sariñena	سارينينا
sarratella	ساراتيليا
sarreal	ساريال
sarreaus	سارياوس
sarria	ساريا
sarrion	ساريون
sarroca	ساروکا
sarvise	سارويسه
sasamon	ساسامون
sasdonigas	ساسذونيغاس
sastago	ساستاغو
sauca	ساوکا
saucedilla	ساوثيذيليا
saucelle	ساوثيله
saviñan	ساوينان
saviñao	ساويناو
sax	ساکس
sayaton	ساياتون
sebulcor	سيوولکور
secorun	سيکورون
sedano	سيذانو
sedella	سيذيليا
segorbe	سيغوروه
segurilla	سيغوريليا
selaya	سيلايا
selgua	سيلغوا
sella	سيليا
sellano	سيليانو
selva	سيلوا
semillas	سيميلياس
sena	سينا
senes	سينيس
senmanat	سينمانات
senra	سينرا
senterada	سينتيراذا
sepulveda	سيپولويذا
sequeros	سيکيروس
serantes	سيرانتيس
seriña	سيرينا
seron	سيرون
seros	سيروس
serra	سيرا
serrada	سيراذا
serradero	سيراذيرو
serradilla	سيراذيليا
serranillos	سيرانيليوس
serrateix	سيراتييکس
serrejon	سيريخون
sesa	سيسا
seseña	سيسينا
sesma	سيسما
sestao	سيستاو
sestrica	سيستريکا
setcases	سيتکاسيس
setenil	سيتينيل
setiles	سيتيليس
seva	سيوا
sevilla	سيويليا
seville	سيويله
sierro	سيرو
sietamo	سيتامو
sigüenza	سيغوينثا
sigüés	سيغويس
siles	سيليس
silla	سيليا
silleda	سيليذا
sils	سيلس
simancas	سيمانکاس
sineu	سينيو
sinlabajos	سينلاواخوس
sipan	سيپان
siruela	سيرويلا
sisamon	سيسامون
sisante	سيسانته
sober	سووير
sobradillo	سووراذيليو
sobrado	سووراذو
sobrelapeña	سووريلاپينا
sobrescobio	سووريسکوويو
socobos	سوکووس
socuellamos	سوکويلياموس
sodupe	سوذوپه
solares	سولاريس
solera	سوليرا
solivella	سوليويليا
sollana	سوليانا
soller	سولير
solosancho	سولوسانچو
solsona	سولسونا
somio	سوميو
somolinos	سومولينوس
somontano	سومونتانو
somontin	سومونتين
somosierra	سوموسيرا
somozas	سوموثاس
soncillo	سونثيليو
sondica	سونديکا
soneja	سونيخا
sopeira	سوپييرا
sorbas	سورواس
soria	سوريا
sorihuela	سورياويلا
sorlada	سورلاذا
sorpe	سورپه
sorribes	سوريويس
sort	سورت
sorzano	سورثانو
soses	سوسيس
sotes	سوتيس
sotiello	سوتيليو
sotodosos	سوتوذوسوس
sotomayor	سوتومايور
sotopalacios	سوتوپالاثيوس
sotos	سوتوس
sotoserrano	سوتوسيرانو
sotresgudo	سوتريسغوذو
sotuelamos	سوتويلاموس
suances	سوانثيس
subijana	سوويخانا
subirana	سوويرانا
sucina	سوثينا
sudanell	سوذانيلي
sueca	سويکا
sumbilla	سومبيليا
suria	سوريا
tabara	تاوارا
taberno	تاويرنو
taboada	تاوواذا
taboadela	تاوواذيلا
tabuenca	تاووينکا
tafalla	تافاليا
tahal	تاآل
tahus	تااوس
tal	تال
talamantes	تالامانتيس
talarrubias	تالارووياس
talavan	تالاوان
talayon	تالايون
talayuela	تالايويلا
talayuelas	تالايويلاس
talayuelo	تالايويلو
taliga	تاليغا
talladell	تالياذيلي
tallante	تاليانته
tamajon	تاماخون
tamame	تامامه
tamames	تاماميس
tamariu	تاماريو
tambre	تامبره
tamurejo	تاموريخو
tapioles	تاپيوليس
taracena	تاراثينا
taradell	تاراذيلي
taramundi	تاراموندي
tarancon	تارانکون
taravilla	تاراويليا
tarazona	تاراثونا
tarbena	تاروينا
tardajos	تارذاخوس
tardelcuende	تارذيلکوينده
tardienta	تارذينتا
tarifa	تاريفا
tarija	تاريخا
tarna	تارنا
tarragona	تاراغونا
tarrasa	تاراسا
tarrega	تاريغا
tarrio	تاريو
tarroja	تاروخا
tarros	تاروس
tauste	تاوسته
tavaruela	تاوارويلا
tazones	تاثونيس
teba	تيوا
tebar	تيوار
tejadillos	تيخاذيليوس
tejares	تيخاريس
tejeiro	تيخييرو
tejera	تيخيرا
tembleque	تيمبليکه
tempul	تيمپول
tendilla	تينديليا
tenebron	تينيورون
teo	تيو
termens	تيرمينس
termino	تيرمينو
terminon	تيرمينون
terradas	تيراذاس
terriente	تيرينته
terrinches	تيرينچيس
terroba	تيرووا
teruel	تيرويل
teulada	تيولاذا
teverga	تيويرغا
tiana	تيانا
tibi	تيوي
tibidabo	تيويذاوو
tiebas	تيواس
tiedra	تيذرا
tielve	تيلوه
tierga	تيرغا
tiermas	تيرماس
tierzo	تيرثو
tiesa	تيسا
tijola	تيخولا
tinajas	تيناخاس
tineo	تينيو
tiñosillos	تينوسيليوس
tirgo	تيرغو
tirig	تيريغ
tirteafuera	تيرتيافويرا
titaguas	تيتاغواس
tiurana	تيورانا
tivenys	تيوينيس
tivisa	تيويسا
tobarra	تووارا
tobia	توويا
tocina	توثينا
todellego	توذيليغو
todolella	توذوليليا
toledo	توليذو
tolocirio	تولوثيريو
tolosa	تولوسا
tolox	تولوکس
tolva	تولوا
tomelloso	توميليوسو
tomiño	تومينو
tona	تونا
topares	توپاريس
toques	توکيس
tor	تور
tora	تورا
toras	توراس
tordehumos	تورذياوموس
tordera	تورذيرا
tordomar	تورذومار
tordoya	تورذويا
torello	توريليو
toreno	تورينو
torija	توريخا
toril	توريل
torla	تورلا
tormon	تورمون
tornavacas	تورناواکاس
toro	تورو
torquemada	تورکيماذا
torralba	تورالوا
torreadrada	تورياذراذا
torrebeleña	توريويلينا
torrebeses	توريويسيس
torrecaballeros	توريکاواليروس
torrecampo	توريکامپو
torrecilla	توريثيليا
torredembarra	توريذيمبارا
torredonjimeno	توريذونخيمينو
torrefarrera	توريفاريرا
torregrosa	توريغروسا
torreiglesias	تورييغليسياس
torrejoncillo	توريخونثيليو
torrelaguna	توريلاغونا
torrelapaja	توريلاپاخا
torrelavega	توريلاويغا
torrellano	توريليانو
torrellas	توريلياس
torrelobaton	توريلوواتون
torrelodones	توريلوذونيس
torremanzanas	توريمانثاناس
torremayor	توريمايور
torremegia	توريميخيا
torremocha	توريموچا
torremolinos	توريمولينوس
torremontalbo	توريمونتالوو
torrente	تورينته
torrenueva	تورينويوا
torreorgaz	توريورغاث
torreperogil	توريپيروخيل
torrequebradilla	توريکيوراذيليا
torrequemada	توريکيماذا
torres	توريس
torresandino	توريساندينو
torresmenudas	توريسمينوذاس
torrevelilla	توريويليليا
torrevieja	توريويخا
torrijas	توريخاس
torrijo	توريخو
torrijos	توريخوس
torronteras	تورونتيراس
torrox	توروکس
tortajada	تورتاخاذا
tortella	تورتيليا
tortola	تورتولا
tortonda	تورتوندا
tortuera	تورتويرا
tortuero	تورتويرو
torviscon	تورويسکون
torviscoso	تورويسکوسو
tosas	توساس
totana	توتانا
totanes	توتانيس
touro	توورو
tous	تووس
trabada	تراواذا
trabadelo	تراواذيلو
trabanca	تراوانکا
trabazos	تراواثوس
tragacete	تراغاثيته
traiguera	ترايغيرا
tramacastilla	تراماکاستيليا
trasierra	تراسيرا
traslavina	تراسلاوينا
trasmiras	تراسميراس
trasobares	تراسوواريس
traspinedo	تراسپينيذو
trazo	تراثو
trebujena	تريووخينا
tredos	تريذوس
tremp	تريمپ
tresjuncos	تريسخونکوس
treto	تريتو
trevelez	تريويليث
treviana	تريويانا
trevias	تريوياس
treviño	تريوينو
triacastela	ترياکاستيلا
trigueros	تريغيروس
trillo	تريليو
triollo	تريوليو
triste	تريسته
troncedo	ترونثيذو
tronchon	ترونچون
trubia	تروويا
truchas	تروچاس
truchillas	تروچيلياس
trujillanos	تروخيليانوس
trujillo	تروخيليو
trujillos	تروخيليوس
tudanca	توذانکا
tudela	توذيلا
tuejar	تويخار
tulebras	توليوراس
turcia	تورثيا
turegano	توريغانو
turis	توريس
turleque	تورليکه
turon	تورون
turre	توره
turrillas	توريلياس
turruncun	تورونکون
tuy	توي
ubeda	اوويذا
ubidea	اوويذيا
ubrique	اووريکه
uceda	اوثيذا
ucero	اوثيرو
udias	اوذياس
ugijar	اوخيخار
ujo	اوخو
ujue	اوخوه
ulea	اوليا
ulldecona	اوليديکونا
ulldemolins	اوليديمولينس
umbrete	اومبريته
uña	اونا
uncastillo	اونکاستيليو
unquera	اونکيرا
unzue	اونثوه
urbies	اورويس
urda	اورذا
urracal	اوراکال
urries	اوريس
urroz	اوروث
urueña	اوروينا
urueñas	اورويناس
usagre	اوساغره
used	اوسيذ
useras	اوسيراس
utebo	اوتيوو
utiel	اوتيل
utrera	اوتريرا
utrillas	اوتريلياس
uztarroz	اوثتاروث
vadocondes	باذوکونديس
vadollano	باذوليانو
valacloche	بالاکلوچه
valcavadillo	بالکاواذيليو
valdaracete	بالداراثيته
valdarachas	بالداراچاس
valdeajos	بالدياخوس
valdeavero	بالدياويرو
valdeaveruelo	بالدياويرويلو
valdecaballeros	بالديکاواليروس
valdecabras	بالديکاوراس
valdecarros	بالديکاروس
valdecebollas	بالديثيوولياس
valdecebro	بالديثيورو
valdeconcha	بالديکونچا
valdeconejos	بالديکونيخوس
valdecuenca	بالديکوينکا
valdedios	بالديذيوس
valdefresno	بالديفريسنو
valdefuentes	بالديفوينتيس
valdegamas	بالديغاماس
valdeganga	بالديغانگا
valdegovia	بالديغوويا
valdehijaderos	بالديايخاذيروس
valdelagua	بالديلاغوا
valdelaguna	بالديلاغونا
valdelcubo	بالديلکوو
valdelinares	بالديليناريس
valdelosa	بالديلوسا
valdelugueros	بالديلوغيروس
valdemaluque	بالديمالوکه
valdemorillo	بالديموريليو
valdemoro	بالديمورو
valdenoceda	بالدينوثيذا
valdenoches	بالدينوچيس
valdeobispo	بالديوويسپو
valdeolivas	بالديوليواس
valdeorras	بالديوراس
valdepeñas	بالديپيناس
valdepielago	بالديپيلاغو
valdepolo	بالديپولو
valdeprados	بالديپراذوس
valderas	بالديراس
valderrey	بالديريي
valderrobres	بالديرووريس
valdesamario	بالديساماريو
valdesaz	بالديساث
valdespina	بالديسپينا
valdespino	بالديسپينو
valdestillas	بالديستيلياس
valdeteja	بالديتيخا
valdetorres	بالديتوريس
valdevimbre	بالديويمبره
valdezarza	بالديثارثا
valdihuelo	بالدياويلو
valdilecha	بالديليچا
valdoviño	بالدووينو
valdunquillo	بالدونکيليو
valencia	بالينثيا
valenzuela	بالينثويلا
valeria	باليريا
valga	بالغا
valjunquera	بالخونکيرا
vallada	بالياذا
valladolises	بالياذوليسيس
vallanca	باليانکا
vallbona	باليوونا
valldemosa	باليديموسا
valle	باله
vallecas	باليکاس
vallelado	باليلاذو
vallfogona	باليفوغونا
vallibona	باليوونا
vallirana	باليرانا
vallmoll	باليمولي
vallromanas	باليروماناس
valls	باليس
valmala	بالمالا
valmaseda	بالماسيذا
valmojado	بالموخاذو
valnera	بالنيرا
valor	بالور
valronquillo	بالرونکيليو
valseca	بالسيکا
valsequillo	بالسيکيليو
valtajeros	بالتاخيروس
vandellos	بانديليوس
vañes	بانيس
vascongadas	باسکونگاذاس
vecinos	بيثينوس
vedra	بيذرا
vegadeo	بيغاذيو
vegamian	بيغاميان
veganzones	بيغانثونيس
vegapagar	بيغاپاغار
vegaquemada	بيغاکيماذا
vegarienza	بيغارينثا
velada	بيلاذا
velascalvaro	بيلاسکالوارو
velefique	بيليفيکه
velilla	بيليليا
vellisca	بيليسکا
vendrell	بيندريلي
venialbo	بينيالوو
ventas	بينتاس
ventillas	بينتيلياس
venturada	بينتوراذا
vera	بيرا
verdu	بيرذو
verea	بيريا
veredas	بيريذاس
vergara	بيرغارا
vergel	بيرخيل
verges	بيرخيس
verin	بيرين
vezdemarban	بيثذيماروان
viacamp	بياکامپ
viana	بيانا
vianos	بيانوس
viascon	بياسکون
viator	بياتور
vicalvaro	بيکالوارو
vicar	بيکار
vicien	بيثين
vicolozano	بيکولوثانو
vidangoz	بيذانگوث
vidiago	بيذياغو
vidreras	بيذريراس
viella	بيليا
viguera	بيغيرا
vilabella	بيلاويليا
vilaboa	بيلاووا
vilada	بيلاذا
vilademat	بيلاذيمات
vilademuls	بيلاذيمولس
viladrau	بيلاذراو
vilagrasa	بيلاغراسا
vilaller	بيلالير
vilanova	بيلانووا
vilaplana	بيلاپلانا
vilapouca	بيلاپووکا
vilarrodona	بيلاروذونا
vilaseca	بيلاسيکا
vilatan	بيلاتان
vilches	بيلچيس
villabona	بيلياوونا
villacañas	بيلياکاناس
villacarriedo	بيلياکاريذو
villacarrillo	بيلياکاريليو
villacastin	بيلياکاستين
villaconejos	بيلياکونيخوس
villada	بيلياذا
villadecanes	بيلياذيکانيس
villadepera	بيلياذيپيرا
villadiego	بيلياذيغو
villaescusa	بيليايسکوسا
villafames	بيليافاميس
villaflores	بيليافلوريس
villafranca	بيليافرانکا
villafranqueza	بيليافرانکيثا
villafrechos	بيليافريچوس
villafruela	بيليافرويلا
villagaton	بيلياغاتون
villager	بيلياخير
villagonzalo	بيلياغونثالو
villahermosa	بيلياايرموسا
villahoz	بيليااوث
villajoyosa	بيلياخويوسا
villalba	بيليالوا
villalengua	بيليالينگوا
villalmanzo	بيليالمانثو
villalonga	بيليالونگا
villalpando	بيليالپاندو
villalube	بيليالووه
villaluenga	بيليالوينگا
villalumbroso	بيليالومبروسو
villalvaro	بيليالوارو
villamalea	بيلياماليا
villamalur	بيليامالور
villamañan	بيليامانان
villamandos	بيلياماندوس
villamanrique	بيليامانريکه
villamanta	بيليامانتا
villamantilla	بيليامانتيليا
villamarin	بيليامارين
villamartin	بيليامارتين
villamayor	بيليامايور
villamea	بيلياميا
villamediana	بيلياميذيانا
villamejil	بيلياميخيل
villamesias	بيلياميسياس
villamizar	بيلياميثار
villamol	بيليامول
villamuelas	بيليامويلاس
villanúa	بيليانوا
villanubla	بيليانوولا
villanueva	بيليانويوا
villaobispo	بيلياوويسپو
villapalacios	بيلياپالاثيوس
villaquejida	بيلياکيخيذا
villaquilambre	بيلياکيلامبره
villaralbo	بيليارالوو
villaralto	بيليارالتو
villarejo	بيلياريخو
villarente	بيليارينته
villaricos	بيلياريکوس
villarino	بيليارينو
villarrabe	بيلياراوه
villarramiel	بيلياراميل
villarrasa	بيلياراسا
villarreal	بيلياريال
villarrobledo	بيليارووليذو
villarrodrigo	بيلياروذريغو
villarroya	بيليارويا
villarrubia	بيلياروويا
villarrubio	بيلياروويو
villasabariego	بيلياساواريغو
villasandino	بيلياساندينو
villasante	بيلياسانته
villasarracino	بيلياساراثينو
villasayas	بيلياساياس
villaseca	بيلياسيکا
villaselan	بيلياسيلان
villasilos	بيلياسيلوس
villasrubias	بيلياسرووياس
villastar	بيلياستار
villatobas	بيلياتوواس
villatoro	بيلياتورو
villatoya	بيلياتويا
villaturiel	بيلياتوريل
villava	بيلياوا
villavaquerin	بيلياواکيرين
villavendimio	بيلياوينديميو
villaviciosa	بيلياويثيوسا
villaviudas	بيلياويوذاس
villayon	بيليايون
villaza	بيلياثا
villegas	بيليغاس
villel	بيليل
villena	بيلينا
villerias	بيليرياس
villodrigo	بيليوذريغو
villoldo	بيليولدو
villora	بيليورا
villores	بيليوريس
villoria	بيليوريا
vilvestre	بيلويستره
vimianzo	بيميانثو
vinaceite	بيناثييته
vinaroz	بيناروث
vindel	بينديل
vinebre	بينيوره
viñuela	بينويلا
viñuelas	بينويلاس
vinuesa	بينويسا
viruela	بيرويلا
visaurin	بيساورين
visiedo	بيسيذو
vitigudino	بيتيغوذينو
viver	بيوير
vivero	بيويرو
viveros	بيويروس
vizcaínos	بيثکاينوس
vizmanos	بيثمانوس
yanguas	يانگواس
yatova	ياتووا
yebes	يويس
yebra	يورا
yecla	يکلا
yegen	يخين
yela	يلا
yepes	يپيس
yerga	يرغا
yesa	يسا
yeste	يسته
yuncler	يونکلير
yuncos	يونکوس
yunquera	يونکيرا
zafarraya	ثافارايا
zagra	ثاغرا
zahara	ثاآرا
zahinos	ثااينوس
zaidin	ثايذين
zalla	ثاليا
zamarramala	ثامارامالا
zamayon	ثامايون
zambra	ثامبرا
zambrana	ثامبرانا
zamora	ثامورا
zaorejas	ثاوريخاس
zaragoza	ثاراغوثا
zaratan	ثاراتان
zarauz	ثاراوث
zarra	ثارا
zarzalejo	ثارثاليخو
zas	ثاس
zizur	ثيثور
zorita	ثوريتا
zubia	ثوويا
zubieta	ثوويتا
zubiri	ثوويري
zucaina	ثوکاينا
zudaire	ثوذايره
zuera	ثويرا
zuheros	ثوايروس
zujar	ثوخار
zumarraga	ثوماراغا
zumaya	ثومايا
zuniga	ثونيغا
zurgena	ثورخينا
zurzarren	ثورثارين
