# Baby names
ಅಕಾರ್ಯಸುತಾ	اكاریسوتا
ಅಕ್ಶಿತೀ	اكشیتی
ಅಕ್ಷಥಾ	اكشتها
ಅಕ್ಷೀ	اكشی
ಅಗ್ನಿಜ್ವಾಳಾ	اجنیجوارا
ಅಗ್ರತಾ	اجرتا
ಅಘನ್ಯ	اجهنی
ಅಚ್ಯುತಾನ	اتشیوتان
ಅಜಸ್ಥಾ	اجستها
ಅದವೈಕಾ	ادوایكا
ಅದಾಮ	ادام
ಅದಿಥಾ	ادیتها
ಅದೀಕ್ಯಾ	ادیكیا
ಅದೀತೀಯ	ادیتیی
ಅದ್ರಿತಾ	ادریتا
ಅದ್ರಿಯನ	ادریین
ಅದ್ರೀಶ	ادریش
ಅದ್ಶಯಾ	ادشیا
ಅಧರ್ಷ	ادهرش
ಅಧಾವನ	ادهاون
ಅಧಿನೀ	ادهینی
ಅಧ್ಯುತ	ادهیوت
ಅಧ್ರೀತಾ	ادهریتا
ಅನಿಯಾ	انییا
ಅಬೀನಂದಾ	ابینندا
ಅಬೀರಾಮ	ابیرام
ಅಬೀಶ	ابیش
ಅಬೀಸೇಶನ	ابیسیشن
ಅಬ್ಜಾಯೋನೀ	ابجایونی
ಅಬ್ಬೀರ	اببیر
ಅಭರಾಮ	ابهرام
ಅಭಿಜನ	ابهیجن
ಅಭಿಜ್ಞಾ	ابهیجنا
ಅಭಿಜ್ಞಾನ	ابهیجنان
ಅಭಿನಾ	ابهینا
ಅಭಿನಿವೇಶ	ابهینیویش
ಅಭಿನುಂ	ابهینون
ಅಭಿಮ	ابهیم
ಅಭಿರಾತ	ابهیرات
ಅಭಿರುಚಿ	ابهیروتشی
ಅಭಿರುಪಾ	ابهیروبا
ಅಭಿಷೇಕ	ابهیشیك
ಅಭಿಹೀತಾ	ابهیهیتا
ಅಭೀಕರ್ಷ	ابهیكرش
ಅಭೀಜೀಥ	ابهیجیته
ಅಭೀದೀ	ابهیدی
ಅಭೀಧಾ	ابهیدها
ಅಭೀಪುಜ	ابهیبوج
ಅಭೀಶ್ರೇಯ	ابهیشریی
ಅಭೀಸಿರಾತ	ابهیسیرات
ಅಭ್ಯುದಯ	ابهیودی
ಅಭ್ರಕಾಸಿನ	ابهركاسین
ಅಸಿರಾ	اسیرا
ಅಹಂಕಾರಾ	اهنكارا
ಅಹ್ರ್ಮ್ಶುಲ್ಲಾ	اهرمشوللا
ಅಹ್ಲಾದಾಜನನೀ	اهلاداجننی
ಆಕರ್ಷಕ	آكرشك
ಆತಿಶ	آتیش
ಆದರ್ಶಾ	آدرشا
ಆದಿನಾಥ	آدیناته
ಆದಿಪುರುಷ	آدیبوروش
ಆದ್ಯಾ	آدیا
ಆಧಿರಾ	آدهیرا
ಆಧಿರಾಇ	آدهیراإ
ಆಧೀರೇನ	آدهیرین
ಆನಂದತಾ	آنندتا
ಆನಂದಿತ	آنندیت
ಆನೀಕ	آنیك
ಆನೀಕಾ	آنیكا
ಆಪೇಕ್ಷಾ	آبیكشا
ಆಭಾತ	آبهات
ಆಯಾಂಶ	آیانش
ಆಯುಷ	آیوش
ಆಯುಸ	آیوس
ಆರಾತ್ರಿಕಾ	آراتریكا
ಆರಾಥನಾ	آراتهنا
ಆರಾಧಕ	آرادهك
ಆರೀವ	آریو
ಆರುನ್ಯ	آرونی
ಆರೋಹೀ	آروهی
ಆರ್ಜವ	آرجو
ಆರ್ನವ	آرنو
ಆರ್ಪಿತ	آربیت
ಆರ್ಯಮನ	آریمن
ಆರ್ಯವೀರ	آریویر
ಆಲೋಕಾ	آلوكا
ಆವೀಶ	آویش
ಆಸರಾ	آسرا
ಆಸ್ಯಾ	آسیا
ಆಹಾನ	آهان
ಆಹ್ನೀಕ	آهنیك
ಇಂದುಕಲಾ	إندوكلا
ಇಂದುಲಾಲಾ	إندولالا
ಇತಿಶ್ರೀ	إتیشری
ಇನೀಯನ	إنیین
ಇನ್ದೀವರ	إندیور
ಇನ್ದುಕಾಂತಾ	إندوكانتا
ಇನ್ದುಜ	إندوج
ಇನ್ದುದಾರ	إندودار
ಇನ್ದುಶ್ರೀ	إندوشری
ಇನ್ದ್ರಕಾಂತಾ	إندركانتا
ಇನ್ದ್ರಜಿತ	إندرجیت
ಇನ್ದ್ರದತ್ತ	إندردتت
ಇನ್ದ್ರವದನ	إندرودن
ಇನ್ಧು	إندهو
ಇಯಲೀಸಾಈ	إیلیساإ
ಇಯ್ಯಾಪ್ಪನ	إییاببن
ಇರಾವತೀ	إراوتی
ಇರೇಶ	إریش
ಇಶೀ	إشی
ಇಸಕೀ	إسكی
ಇಸೀತಾ	إسیتا
ಈನ್ದುಸ	إندوس
ಈರಾವಾಜ	إراواج
ಈಲಾಕ್ಕೀಯಾ	إلاككییا
ಈಶಾನಾ	إشانا
ಈಶುಕ	إشوك
ಈಶ್ತರ	إشتر
ಈಶ್ವರದತ್ತ	إشوردتت
ಈಹಮ	إهم
ಉಜೇಶ	وجیش
ಉಜ್ಜಾನಿನೀ	وججانینی
ಉಜ್ವಳ	وجور
ಉಜ್ಹಾಲಾ	وجهالا
ಉತ್ಕರ್ಷ	وتكرش
ಉತ್ಕರ್ಷಾ	وتكرشا
ಉತ್ತಮ	وتتم
ಉತ್ತಿಯಾ	وتتییا
ಉತ್ಪಲ	وتبل
ಉತ್ಪಲಾಕ್ಷ	وتبلاكش
ಉತ್ಪಲಾಭಾ	وتبلابها
ಉದಯಾ	ودیا
ಉದಾರ್ಚೀಸ	ودارتشیس
ಉದಾರ್ಶ	ودارش
ಉದೇಯ	ودیی
ಉದ್ದೀಪ	وددیب
ಉಧವ	ودهو
ಉಧ್ಗೀತಾ	ودهجیتا
ಉನ್ಮಾ	ونما
ಉಪಂಗ	وبنج
ಉಪನಂದಾ	وبنندا
ಉಪನಾಯಿಕ	وبناییك
ಉಪಮನ್ಯು	وبمنیو
ಉಪಮಾ	وبما
ಉಪಲ	وبل
ಉಪಾಂಶು	وبانشو
ಉಫ್ತಮ	وبهتم
ಉಮೇದ	ومید
ಉರವಶೀ	وروشی
ಉರುಗಾಯ	وروجای
ಉರ್ಜೀತಾ	ورجیتا
ಉರ್ಮಿಲ	ورمیل
ಉರ್ಮಿಲಾ	ورمیلا
ಉಲಗಾಪ್ಪನ	ولجاببن
ಉಲ್ಕಾ	ولكا
ಉಲ್ಕೇಶ	ولكیش
ಉಲ್ಲಾಸಿತ	وللاسیت
ಉಲ್ಲಾಸೀಥಾ	وللاسیتها
ಉಷಾ	وشا
ಉಷ್ಮಾ	وشما
ಉಸ್ಲುಂನನ	وسلوننن
ಋತಿಕಾ	رتیكا
ಏಈರಮ	یإرم
ಏಕತಾ	یكتا
ಏಕನ್ಷಾ	یكنشا
ಏಕೇಸ್ವಾರ	یكیسوار
ಏಕ್ವಿರಾ	یكویرا
ಏಲಾವೇನ್ಧನ	یلاویندهن
ಏಲೀಲೀ	یلیلی
ಏಲೇಥಿಯಾ	یلیتهییا
ಏವರಜ	یورج
ಏಶಾನಿಕಾ	یشانیكا
ಏಸ್ವರದೀತ್ಯ	یسوردیتی
ಏಹೀತ	یهیت
ಐನ್ಗೀನೀ	اینجینی
ಐಷಾ	ایشا
ಓಜಸ್ವಿನೀ	اوجسوینی
ಓಜಸ್ವೀ	اوجسوی
ಓಜಸ್ವೀತಾ	اوجسویتا
ಓನೀರ	اونیر
ಓಮಕಾರ	اومكار
ಓಮಕಾರೀ	اومكاری
ಓಮನಾ	اومنا
ಓರಿಓನ	اوریاون
ಓವೀನ	اووین
ಓಶೀನ	اوشین
ಔಶಿಗ	اوشیج
ಕಂಠ	كنطه
ಕಂಠನ	كنطهن
ಕಟರೀನಾ	كطرینا
ಕತಾನ	كتان
ಕತಾವ್ಯಾ	كتاویا
ಕಥ್ಯನೀ	كتهینی
ಕನಕ	كنك
ಕನಕಾಬತೀ	كنكابتی
ಕನೀಜಾ	كنیجا
ಕನ್ವಕ	كنوك
ಕಪಾಲಿನೀ	كبالینی
ಕಪೀಲೇಶ	كبیلیش
ಕಮಲಕಾಂತ	كملكانت
ಕಮಲನಾಥ	كملناته
ಕಮಲಾ ಸಮಭಾವ	كملا سمبهاو
ಕಮಲಾಕ್ಷೀ	كملاكشی
ಕಯಾಲ್ವೀಝ್ಹೀ	كیالویجههی
ಕಯೋಶ	كیوش
ಕರನ	كرن
ಕರಾಲಾ	كرالا
ಕರುನಾಕರ	كروناكر
ಕರ್ತೀಗಾ	كرتیجا
ಕರ್ತೀಶಾ	كرتیشا
ಕಲರನೀ	كلرنی
ಕಲಹನ	كلهن
ಕಲಾಧರ	كلادهر
ಕಲಾಪಕ	كلابك
ಕಲಾಪಿನೀ	كلابینی
ಕಲಾಸಾವೇರೀ	كلاساویری
ಕಲ್ಪಕ	كلبك
ಕಲ್ಪಿತಾ	كلبیتا
ಕಲ್ಪೇಶ	كلبیش
ಕವನೀ	كونی
ಕವಿತ	كویت
ಕಶ್ವೀ	كشوی
ಕಸ್ತುರ	كستور
ಕಾಂಚನಾ	كانتشنا
ಕಾಂವ	كانو
ಕಾದಮ್ಬಿನೀ	كادمبینی
ಕಾನನಬಾಲಾ	كاننبالا
ಕಾನಾಕಾದರೀ	كاناكادری
ಕಾನೀತಾ	كانیتا
ಕಾನೀನ	كانین
ಕಾನೀಶ್ಕಾರ	كانیشكار
ಕಾನುಶೀ	كانوشی
ಕಾನ್ಚಾನಾಧ್ವಾಜಾ	كانتشانادهواجا
ಕಾಮಮಾಂ	كاممان
ಕಾಮಾ	كاما
ಕಾಮೇರೀನಾ	كامیرینا
ಕಾಮೇಶ್ವರೀ	كامیشوری
ಕಾಯಲವಿಲೀ	كایلویلی
ಕಾರುಣ್ಯ	كارونی
ಕಾರುಣ್ಯ ಪ್ರಕಾಶ	كارونی بركاش
ಕಾರೂಕಾ	كاروكا
ಕಾರ್ತಿಕೇಯನ	كارتیكیین
ಕಾರ್ತೇಕೇಯಾ	كارتیكییا
ಕಾಲಿದಾಸ	كالیداس
ಕಾಲಿಮೋಹನ	كالیموهن
ಕಾವ್ಯನ	كاوین
ಕಾವ್ಯಶ್ರೀ	كاویشری
ಕಾವ್ಯಸ್ರೀ	كاویسری
ಕಾಷ್ಠ	كاشطه
ಕಿಂಜಲ	كینجل
ಕೀಅರಾ	كیارا
ಕೇತನ	كیتن
ಕೇಯಾ	كییا
ಕೇಲಾಕಾ	كیلاكا
ಕೇವಲ	كیول
ಕೇಶೀ	كیشی
ಕೇಸರೀಸುತ	كیسریسوت
ಕೇಸವಾ	كیسوا
ಕೇಸವಾರಾಜ	كیسواراج
ಕೈರವ	كایرو
ಕೈಲಾಶಅಧಿಪತಿ	كایلاشادهیبتی
ಕೌಶಿಕಾ	كاوشیكا
ಕೌಸುಧೀ	كاوسودهی
ಕೌಸ್ತುಭೀ	كاوستوبهی
ಖಗೇನ್ದ್ರ	كهجیندر
ಖನಕ	كهنك
ಖನಿಕಾ	كهنیكا
ಖಾಜಿತ	كهاجیت
ಖುಜಾರಾ	كهوجارا
ಖುಶ್ಬೂ	كهوشبو
ಗಂಗಜ	جنجج
ಗಂಧರ್ವವಿದ್ಯಾ	جندهروویدیا
ಗಜಗಾಮಿನೀ	جججامینی
ಗಜಪತಿ	ججبتی
ಗಜರಾಜ	ججراج
ಗಜಾಧರ	ججادهر
ಗಣಕ	جنك
ಗಣಪತ	جنبت
ಗಣಿತಾ	جنیتا
ಗಣ್ಯಾ	جنیا
ಗತಿತಾ	جتیتا
ಗನಾಕ್ಷೀ	جناكشی
ಗನೇಂದ್ರ	جنیندر
ಗನ್ಗವಾಥೀ	جنجواتهی
ಗರವೀ	جروی
ಗರಿಮಾ	جریما
ಗರ್ಜನ	جرجن
ಗರ್ವಿತ	جرویت
ಗರ್ವಿತಾ	جرویتا
ಗಹನಾ	جهنا
ಗಾಥಾ	جاتها
ಗಾವ್ಯಾ	جاویا
ಗಿರಾ	جیرا
ಗಿರಿಕ	جیریك
ಗಿರಿಜಾನಂದನ	جیریجانندن
ಗಿರ್ವಾನ	جیروان
ಗೀರೀಚಂದ್ರ	جیریتشندر
ಗೀರ್ವೇನ	جیروین
ಗೀಸೇಲೇ	جیسیلي
ಗುನವಂತೀ	جونونتی
ಗುನಾರತ್ನಾ	جونارتنا
ಗುನಾವತೀ	جوناوتی
ಗುನಾಸೇಕರಣ	جوناسیكرن
ಗುನೀತ	جونیت
ಗುನ್ಜೀತಾ	جونجیتا
ಗುನ್ದಾಪಾ	جوندابا
ಗುನ್ರೇಖಾ	جونریكها
ಗುರುದೂತ್ತ	جورودوتت
ಗುರುಬಚನ	جوروبتشن
ಗುರುರಾಜ	جوروراج
ಗುಲಜಾರೀಲಾಲ	جولجاریلال
ಗುಲಮೋಹರ	جولموهر
ಗುಲ್ಜನ	جولجن
ಗುಹಾನ	جوهان
ಗೇಶನಾ	جیشنا
ಗೋಕೀಲಾ	جوكیلا
ಗೋತಮ	جوتم
ಗೋಮಾಂಥೀ	جومانتهی
ಗೋಮ್ಯಾಸರೀ	جومیاسری
ಗೋವಿಂದಾ	جوویندا
ಗೋವಿನ್ದೀ	جوویندی
ಗೋವೀನೇಶ	جووینیش
ಘನಾವೀ	جهناوی
ಚಂಚಾರೀಕ	تشنتشاریك
ಚಂಡಮುಂಡವಿನಾಶಿನೀ	تشندموندویناشینی
ಚಂದನಾ	تشندنا
ಚಂದಸರೀ	تشندسری
ಚಂದ್ರಕಂತೀ	تشندركنتی
ಚಂದ್ರಕಾಂತ	تشندركانت
ಚಂದ್ರಕೀ	تشندركی
ಚಂದ್ರಕೀರ್ತೀ	تشندركیرتی
ಚಂದ್ರಚುರ	تشندرتشور
ಚಂದ್ರಥಾ	تشندرتها
ಚಂದ್ರನ್ಶುಂ	تشندرنشون
ಚಂದ್ರಮುಖೀ	تشندرموكهی
ಚಂದ್ರರಾಜ	تشندرراج
ಚಂದ್ರಲೇಕ್ಷಾ	تشندرلیكشا
ಚಂದ್ರಿಮಾ	تشندریما
ಚಂದ್ರು	تشندرو
ಚಂಧು	تشندهو
ಚಕೋರೀ	تشكوری
ಚಕ್ರಾಹೀಂ	تشكراهین
ಚಕ್ಷಸ	تشكشس
ಚತುರ್ಬಹಾವೇ	تشتوربهاوي
ಚನ್ದ್ರಜ್ಯೋತಿ	تشندرجیوتی
ಚನ್ದ್ರವದನ	تشندرودن
ಚನ್ದ್ರಸಹೋದಾರೀ	تشندرسهوداری
ಚರುಲಾ	تشرولا
ಚಾತುರ್ಯ	تشاتوری
ಚಾನಾಸ್ಯಾ	تشاناسیا
ಚಾನ್ದಿನೀ	تشاندینی
ಚಾನ್ನಕ್ಕಾ	تشاننككا
ಚಾಯನಾ	تشاینا
ಚಾರುದತ್ತ	تشارودتت
ಚಾರುಪ್ರಭಾ	تشاروبربها
ಚಾರ್ವೀ	تشاروی
ಚಿಂತ್ಯಾ	تشینتیا
ಚಿತಾಯು	تشیتایو
ಚಿತ್ತರಂಜನೀ	تشیتترنجنی
ಚಿತ್ತಸ್ವರೂಪ	تشیتتسوروب
ಚಿತ್ತೇಶ	تشیتتیش
ಚಿತ್ರಂಶ	تشیترنش
ಚಿತ್ರಕುನ್ಧಾಲಾ	تشیتركوندهالا
ಚಿತ್ರಬಾನಾ	تشیتربانا
ಚಿತ್ರಾದೇವೀ	تشیترادیوی
ಚಿತ್ರಾನೀ	تشیترانی
ಚಿತ್ರೀನೀ	تشیترینی
ಚಿದಂಬರಮ	تشیدنبرم
ಚಿದಾನಂದಾ	تشیدانندا
ಚಿನಾರ	تشینار
ಚೀನ್ಕಲ	تشینكل
ಚೀನ್ನಾಮಾಂಸ್ತೀಕಾ	تشیننامانستیكا
ಚೀನ್ನೀಃ	تشیننیها
ಚೇತಕ	تشیتك
ಚೇತನ್ದೀಪ	تشیتندیب
ಚೈತ್ರಯೇಶ	تشایترییش
ಚೋಲನ	تشولن
ಛೋಟು	تشهوطو
ಜಗತವೀರ	ججتویر
ಜಗದಬಂದು	ججدبندو
ಜಗ್ವೀರ	ججویر
ಜನತಾ	جنتا
ಜನೀಶಾ	جنیشا
ಜನ್ಮೇಶ	جنمیش
ಜಪೇಶ	جبیش
ಜಪ್ತೇಶ	جبتیش
ಜಬಿನೇ	جبیني
ಜಮಾಂದಾಗ್ನ್ಯ ಮಹಾದಾರ್ಪಾ	جمانداجنی مهاداربا
ಜಯ ಪ್ರಕಾಶ	جی بركاش
ಜಯಂತಾ	جینتا
ಜಯಚಂದ	جیتشند
ಜಯಪ್ರಭಾ	جیبربها
ಜಯಾ ಕುಮಾರೀ	جیا كوماری
ಜಯಾಕೀರ್ಥೀ	جیاكیرتهی
ಜಯಾಸಂಕರ	جیاسنكر
ಜಯೀನ	جیین
ಜಯೇನ್ದ್ರ	جییندر
ಜಯ್ಮೀನೀ	جیمینی
ಜಲಜ	جلج
ಜಲದ	جلد
ಜಲಧೀಜಾ	جلدهیجا
ಜಲಾರ್ಕ	جلارك
ಜಲ್ಪೂರ್ನಾ	جلبورنا
ಜವಾಹರೀ	جواهری
ಜಶವಂತ	جشونت
ಜಶೋದಾ	جشودا
ಜಶ್ಮೀನಾ	جشمینا
ಜಸಜೀತ	جسجیت
ಜಸಬೀರ	جسبیر
ಜಸಮಿತ	جسمیت
ಜಸರಾಜ	جسراج
ಜಸವೀರ	جسویر
ಜಸೀಮಾ	جسیما
ಜಸ್ಕೀರಿತ	جسكیریت
ಜಸ್ಮಿಕಾ	جسمیكا
ಜಸ್ಮೀಥ್ಯಾ	جسمیتهیا
ಜಹನಕ	جهنك
ಜಾಂಸೀ	جانسی
ಜಾಗ	جاج
ಜಾಗವೀ	جاجوی
ಜಾಗೃತಿ	جاجرتی
ಜಾನಕೀಭೂಷಣ	جانكیبهوشن
ಜಾನಕೀರಮನ	جانكیرمن
ಜಾನಾ	جانا
ಜಾನ್ವೀ	جانوی
ಜಾಪಕ	جابك
ಜಾಹೀ	جاهی
ಜಿಜ್ಞಾಸಾ	جیجناسا
ಜಿತೇನ್ದ್ರಿಯ	جیتیندریی
ಜಿಶ್ನು	جیشنو
ಜೀಗೇನ	جیجین
ಜೀಜ್ಞಾಶಾ	جیجناشا
ಜೀತನ	جیتن
ಜೀತಾಕಮ	جیتاكم
ಜೀತಾವಾರಆಶಯೇ	جیتاوارآشیي
ಜೀನ್ದಾಲ	جیندال
ಜೀಯಾಂಶೀ	جییانشی
ಜೀವೀ	جیوی
ಜೀಶನಾ	جیشنا
ಜೇನ್ನಯ	جیننی
ಜೇಯಾನ್ದ್ರಣ	جییاندرن
ಜೇರ್ರೀಷ	جیرریش
ಜೇರ್ಶೀಕಾ	جیرشیكا
ಜೈಚಾನ್ದ್ರಣ	جایتشاندرن
ಜೈನ	جاین
ಜೈಸಲ	جایسل
ಜೈಹಾಸೀನೀ	جایهاسینی
ಜೋಸ್ಯಾ	جوسیا
ಜ್ಞಾನದೇವ	جناندیو
ಜ್ಞಾನಾ	جنانا
ಜ್ಞಾನಾಲ	جنانال
ಜ್ಞಾನೇಶ್ವರೀ	جنانیشوری
ಜ್ಯೋತಿರ್ಮೋಯೀ	جیوتیرمویی
ಜ್ಯೋತಿಷಮತಿ	جیوتیشمتی
ಜ್ಯೋಥೀರ್ಮಾಈ	جیوتهیرماإ
ಜ್ಹಂಕರ	جهنكر
ಜ್ಹಿಲ	جهیل
ಝರಲ	جهرل
ಝವಿಯನ	جهویین
ಝಾರಾ	جهارا
ಝೀಣೀ	جهینی
ಝೇನೀತ	جهینیت
ಝೇನೀಶಾ	جهینیشا
ಝ್ಯನಾ	جهینا
ಟಿಮ್ಮೀ	طیممی
ಠುಮಕೀ	طهومكی
ಠುಮರೀ	طهومری
ಡಿಮ್ಪೀ	دیمبی
ತಂಗವೇಲ	تنجویل
ತಂತ್ರ	تنتر
ತಂಸೀ	تنسی
ತಕ್ಶೀಲ	تكشیل
ತಜಜ್ಞ	تججن
ತಜಸರೀ	تجسری
ತತ್ವಗ್ಯಾನಾಪ್ರದ	تتوجیانابرد
ತನವೀರ	تنویر
ತನಾವ	تناو
ತನೇಶ	تنیش
ತನ್ವಿಕಾ	تنویكا
ತನ್ವೀಶ್ರೀ	تنویشری
ತಪಸ	تبس
ತಪಸ್ವೀ	تبسوی
ತಮಸ	تمس
ತಮಾಯಾನ್ಥ್ಯ	تمایانتهی
ತಮಾಸ್ವೀ	تماسوی
ತಮಿಲಾ	تمیلا
ತಮೇಶ	تمیش
ತರಂಗಿನೀ	ترنجینی
ತರಲ	ترل
ತರಸ್ವೀನ	ترسوین
ತರಿತ	تریت
ತರುಶೀ	تروشی
ತಲ್ಲೀ	تللی
ತಶಾ	تشا
ತಾಕ್ಸ್ವೀಹ	تاكسویه
ತಾನಾಸೀ	تاناسی
ತಾನ್ಹಿತಾ	تانهیتا
ತಾಮಾಂಶ್ರೀ	تامانشری
ತಾಮಾಸ್ವಿನೀ	تاماسوینی
ತಾಮಿಲಸೇಲ್ವೀ	تامیلسیلوی
ತಾಯೀನ	تایین
ತಾರಾಕ್ಷ	تاراكش
ತಾರಾಚಂದ	تاراتشند
ತಾರಾನೀಸೇನ	تارانیسین
ತಾರೀಶೀ	تاریشی
ತಾಲಿನ	تالین
ತಾವಾಸ್ಯ	تاواسی
ತಿತಲೀ	تیتلی
ತಿಲಕ	تیلك
ತಿಸ್ಯಾ	تیسیا
ತೀಅನಾ	تیانا
ತೀಯಶಾ	تییشا
ತೀಯಸ	تییس
ತುನಾವಾ	توناوا
ತುರಾನ್ಯು	تورانیو
ತುಲಜಾ	تولجا
ತುಲಸಾ	تولسا
ತುಲೀ	تولی
ತುಲೀಪ	تولیب
ತುಷಾರ	توشار
ತುಷಿತ	توشیت
ತುಷ್ಟಿ	توشطی
ತೇಗವಿರ	تیجویر
ತೇಜಸೀ	تیجسی
ತೇಜಸ್ವೀ	تیجسوی
ತೇಜಸ್ವೀನ	تیجسوین
ತೇಜೀ	تیجی
ತೇಜುಲ	تیجول
ತೇಜೇನದರ	تیجیندر
ತೇಜೇಶ	تیجیش
ತೇವಾನ	تیوان
ತೇಸಶ	تیسش
ತೋಮಾಂಲೀ	تومانلی
ತೋಯಾಜ	تویاج
ತೋಶೀ	توشی
ತೋಶೀನ	توشین
ತೌಲೀಕ	تاولیك
ತ್ರಂಬಕ	ترنبك
ತ್ರಿಂಬಿಕಾ	ترینبیكا
ತ್ರಿಕಾಯಾ	تریكایا
ತ್ರಿಜಲ	تریجل
ತ್ರಿಪುತಾ	تریبوتا
ತ್ರಿಪುರಸುಂದರೀ	تریبورسوندری
ತ್ರಿಪುರಾರೀ	تریبوراری
ತ್ರಿಪ್ತಾ	تریبتا
ತ್ರಿಲೋಕೇಶ	تریلوكیش
ತ್ರಿವಿಕ್ರಮ	تریویكرم
ತ್ರಿವೇಣೀ	تریوینی
ತ್ರಿಶಲಾನಾ	تریشلانا
ತ್ರಿಶಾಲಾ	تریشالا
ತ್ರಿಶುಲಿನೀ	تریشولینی
ತ್ರೀನೇಶ	ترینیش
ತ್ರೀಮ್ಬೀಕಾ	تریمبیكا
ತ್ರೀಲೋಚನನ	تریلوتشنن
ತ್ರೀವೀದ	تریوید
ತ್ರೀಸವಾ	تریسوا
ಥಂಗಾ	تهنجا
ಥಾನೀಶ್ಕಾ	تهانیشكا
ಥಾನುಂಶಾ	تهانونشا
ಥಾರ್ಶೀನೀ	تهارشینی
ಥಾರ್ಸೀನ	تهارسین
ದಂದಾಪಾನೀ	دندابانی
ದಕ್ಶಾಜಾ	دكشاجا
ದಕ್ಷೀ	دكشی
ದಯಾಕರ	دیاكر
ದಯಾನಿತಾ	دیانیتا
ದಯಾಲನ	دیالن
ದರಹಾಸ	درهاس
ದರಿದ್ರಾ ಧಾವ್ಸೀನೀ	دریدرا دهاوسینی
ದರೀತ್ರೀ	دریتری
ದರ್ಮೀನೀ	درمینی
ದರ್ಸೀಕಾ	درسیكا
ದವೇ	دوي
ದಶಾ	دشا
ದಶಾಗ್ರೀವಾ ಶೀರೋಹರಾ	دشاجریوا شیروهرا
ದಾನ್ಸೀಕಾ	دانسیكا
ದಾಮಾ	داما
ದಾರುಕಾ	داروكا
ದಾಶಾರತೀ	داشارتی
ದಿಕ್ಶಾನ್ಯ	دیكشانی
ದಿಕ್ಶೀಕಾ	دیكشیكا
ದಿನ ದಯಾಲ	دین دیال
ದಿಪಂಶೀ	دیبنشی
ದಿಪೇಂದರ	دیبیندر
ದಿಪೇನ	دیبین
ದೀಪ್ತಿಕಾನಾ	دیبتیكانا
ದೀಪ್ತಿಮೋಯ	دیبتیموی
ದೇನೀಷ	دینیش
ದೇಬಸ್ಮಿತಾ	دیبسمیتا
ದೇಬೋಪ್ರಿಯಾ	دیبوبرییا
ದೇಬೋಸ್ಮಿತಾ	دیبوسمیتا
ದೇಬ್ಜಾನೀ	دیبجانی
ದೇಮ್ಧೇನ್ದ್ರ	دیمدهیندر
ದೇಯ್ದಿಪ್ಯಾ	دییدیبیا
ದೇಲೀನಾ	دیلینا
ದೇವ ನರೇನ	دیو نرین
ದೇವದೀಪ	دیودیب
ದೇವನಾಥನ	دیوناتهن
ದೇವಪದ	دیوبد
ದೇವರತ	دیورت
ದೇವರಾಜ	دیوراج
ದೇವರಾಜನ	دیوراجن
ದೇವಲ	دیول
ದೇವಾಂಶು	دیوانشو
ದೇವಾರಹಾಲ್ಲೀ	دیوارهاللی
ದೇವಾಶ್ರೀ	دیواشری
ದೇವೀ	دیوی
ದೇವ್ಬ್ರತಾ	دیوبرتا
ದೇವ್ಮುಕೀಲ	دیوموكیل
ದೇವ್ಯೋಶಾ	دیویوشا
ದೇಶಿಕ	دیشیك
ದೈತ್ಯ ಸಾಈ	دایتی ساإ
ದೈನಾ	داینا
ದೈವಂಶ	دایونش
ದ್ಯುತಿ	دیوتی
ಧನಶಿಕಾ	دهنشیكا
ಧನ್ವಿಕಾ	دهنویكا
ಧರಿಯಾ	دهرییا
ಧರ್ಮ	دهرم
ಧರ್ಮಜಾ	دهرمجا
ಧರ್ಮದಿತ್ಯ	دهرمدیتی
ಧಾತ್ರೀ	دهاتری
ಧಾನ	دهان
ಧಾನೀತ	دهانیت
ಧಾನೀಶಾ	دهانیشا
ಧಾಮೀನೀ	دهامینی
ಧಾಮೋಧಾರ	دهامودهار
ಧಾವಿತ	دهاویت
ಧಿತಿ	دهیتی
ಧೀಯಾನ	دهییان
ಧುಹಿತಾ	دهوهیتا
ಧೃತಿ	دهرتی
ಧೈರ್ಯ್ಯಾ	دهایرییا
ಧ್ರೀಶೀಕಾ	دهریشیكا
ಧ್ರೀಶ್ತೀಕಾ	دهریشتیكا
ಧ್ರುವಿಕಾ	دهروویكا
ಧ್ವೀಜಾ	دهویجا
ನಂದಕುಮಾರ	نندكومار
ನಕುಲ	نكول
ನಕ್ಷತ್ರಾ	نكشترا
ನಚಿಕೇತಾ	نتشیكیتا
ನತಾಲೀ	نتالی
ನಬರೂಣ	نبرون
ನಭೋಜ	نبهوج
ನಮ್ರಹ	نمره
ನಲಿನ	نلین
ನವಮ	نوم
ನವರಾತನಾ	نوراتنا
ನವಾಲನ	نوالن
ನವೇಂದು	نویندو
ನಾಕುಶ	ناكوش
ನಾಗಧವಾನೀ	ناجدهوانی
ನಾಗರತನಾ	ناجرتنا
ನಾಗಿನೀ	ناجینی
ನಾಗೇನ್ದ್ರ	ناجیندر
ನಾದಿಯಾ	نادیا
ನಾಧಾ	نادها
ನಾಧೀನೀ	نادهینی
ನಾನ್ತೀನೀ	نانتینی
ನಾಬಹ	نابه
ನಾಭೀನತ	نابهینت
ನಾಮೀಶಾ	نامیشا
ನಾಯತ	نایت
ನಾರಾಯಾಣಾ	نارایانا
ನಾರ್ಮಾಂಥಾ	نارمانتها
ನಾರ್ಸೀಮುಲುಂ	نارسیمولون
ನಾಲಾನೀಲ	نالانیل
ನಾಲಾವೇನ್ಭಾ	نالاوینبها
ನಾವಾಪ್ರಿಯನ	ناوابریین
ನಾವಾಮಾಂಲ್ಲೀ	ناوامانللی
ನಾವೀಶಾ	ناویشا
ನಾವ್ಯಶ್ರೀ	ناویشری
ನಾವ್ಯಸರೀ	ناویسری
ನಾವ್ಯಾ	ناویا
ನಾಹುಲ	ناهول
ನಿಕೀನ	نیكین
ನಿಖಾರ	نیكهار
ನಿಖಿಲೇಶ	نیكهیلیش
ನಿದೇಶ	نیدیش
ನಿಧ್ಯಾಥೀ	نیدهیاتهی
ನಿಭಯ	نیبهی
ನಿರಜಾ	نیرجا
ನಿರ್ಜಲಾ	نیرجلا
ನಿಶಾ	نیشا
ನಿಶಿಥಿನೀ	نیشیتهینی
ನಿಹಾರಿಕಾ	نیهاریكا
ನೀಕಮ	نیكم
ನೀಕಾನ್ದರ್ಯ	نیكاندری
ನೀಕೀಲ	نیكیل
ನೀಕುಂಜ	نیكونج
ನೀಕುಲ	نیكول
ನೀಚೀತಾ	نیتشیتا
ನೀಜಾ	نیجا
ನೀಡೀ	نیدی
ನೀತಾ	نیتا
ನೀದೀಶ	نیدیش
ನೀನಾ	نینا
ನೀನ್ನ್ಯ	نیننی
ನೀಭೀಶ	نیبهیش
ನೀರುಧೀ	نیرودهی
ನೀರೇಕ್ಷಾ	نیریكشا
ನೀಲ	نیل
ನೀಲ ಕಾಂತಾ	نیل كانتا
ನೀಲ ಮಾಧವ	نیل مادهو
ನೀಲಂಜನಾ	نیلنجنا
ನೀಲಕಮಾಲಾ	نیلكمالا
ನೀಲದೇವೀ	نیلدیوی
ನೀಲಯ	نیلی
ನೀಲಾಂಜನ	نیلانجن
ನೀಲಾಮ್ಬೇರ	نیلامبیر
ನೀಲೋರ್ಮ್ಯ	نیلورمی
ನೀಲ್ಸಾ	نیلسا
ನೀಶಾಲೀ	نیشالی
ನೀಷ್ಟಾ	نیشطا
ನೀಸಿತೀನೀ	نیسیتینی
ನೀಸ್ಚೀಥಾ	نیستشیتها
ನೀಹಮ	نیهم
ನೀಹಾರಿಕಾ	نیهاریكا
ನೀಹೀಥಾ	نیهیتها
ನೀಹೀರಾ	نیهیرا
ನೇಮಾ	نیما
ನೇಮಾಂಲೀ	نیمانلی
ನೇಹಾರಿಕಾ	نیهاریكا
ನೈತಿ	نایتی
ನೈರೀತೀ	نایریتی
ನೈವೇದ	نایوید
ನೈಷೀ	نایشی
ನೌಬಹಾರ	ناوبهار
ಪಂಕಜ಼ಾ	بنكجا
ಪಂಖೀ	بنكهی
ಪಂಚಮ	بنتشم
ಪಂಚಾಲೀ	بنتشالی
ಪಂಥ	بنته
ಪಂಧಾರೀ	بندهاری
ಪಣ-ಗೇಶ	بن-جیش
ಪತಾಲಾ	بتالا
ಪತ್ರಲಿಕಾ	بترلیكا
ಪದಮಾವತೀ	بدماوتی
ಪದ್ಮಬಂಧೂ	بدمبندهو
ಪದ್ಮಹಸ್ತಾ	بدمهستا
ಪದ್ಮಾಂನಾಭಾ ಪ್ರಿಯಾ	بدماننابها برییا
ಪನೀಶ್ಕಾ	بنیشكا
ಪನ್ಕಾಜಮ	بنكاجم
ಪನ್ದಾಲಾವಾಸನ	بندالاواسن
ಪಪಮ್ಮಾಂ	ببممان
ಪರಮಂದಾ	برمندا
ಪರಮಪುರುಷ	برمبوروش
ಪರಮಹಂಸ	برمهنس
ಪರಮಾ	برما
ಪರಮೇಶ್ವರೀ	برمیشوری
ಪರಮ್ವಾರ್ದಾನ	برمواردان
ಪರವೀನ	بروین
ಪರಾಯಂತ್ರ	براینتر
ಪರಾಶ	براش
ಪರಿಕ್ಷಿತ	بریكشیت
ಪರಿಣೀತಾ	برینیتا
ಪರಿತಾ	بریتا
ಪರಿತುಷ್ಟಿ	بریتوشطی
ಪರಿಷ್ಕಾರ	بریشكار
ಪರಿಹಾ	بریها
ಪರೀಮೀತ	بریمیت
ಪರು	برو
ಪರ್ಣವ	برنو
ಪರ್ಣಿಕಾ	برنیكا
ಪರ್ನಾಭಾ	برنابها
ಪರ್ವತ	بروت
ಪರ್ವತೀಪ್ರಿತ	بروتیبریت
ಪರ್ವತೇಶ್ವರ	بروتیشور
ಪರ್ವನ	برون
ಪಲಾನೀಚಾಮ್ಯ	بلانیتشامی
ಪಲಾಶೀನೀ	بلاشینی
ಪವನ	بون
ಪವೀಥಾ	بویتها
ಪಾಂಖಡೀ	بانكهدی
ಪಾಂಚಾಲೀ	بانتشالی
ಪಾಂಡುರಂಗ	باندورنج
ಪಾಓಲಾ	بااولا
ಪಾರಸ	بارس
ಪಾರಾ	بارا
ಪಾರ್ತೀಬನ	بارتیبن
ಪಾರ್ಥಾಪ್ರತಿಮ	بارتهابرتیم
ಪಾರ್ಥಿಕ	بارتهیك
ಪಾರ್ವತೀ	باروتی
ಪಾರ್ವಾಥೀ	بارواتهی
ಪಾಲ	بال
ಪಾಲನೀವೇಲ	بالنیویل
ಪಾಲೀನ	بالین
ಪಾವಾನಾ	باوانا
ಪಾವಾನೀ	باوانی
ಪಾಸೀ	باسی
ಪಿಂಗಲ	بینجل
ಪಿಂಗಲಾ	بینجلا
ಪಿತಾವಾಸನೇ	بیتاواسني
ಪಿವಾಲ	بیوال
ಪೀಉಶಾ	بیوشا
ಪೀತೋಬಾಶ	بیتوباش
ಪೀನ್ಕೇಶ	بینكیش
ಪೀರನೀಥಾ	بیرنیتها
ಪುರ್ನೀಮಾಂ	بورنیمان
ಪೂಜನ	بوجن
ಪೂಜಾ	بوجا
ಪೂನಿಶ	بونیش
ಪೂರಬ	بورب
ಪೂರ್ವಗಂಗಾ	بوروجنجا
ಪೂರ್ವಜ	بوروج
ಪೂರ್ವಾ	بوروا
ಪೇಮಲ	بیمل
ಪೌಶಾಲೀ	باوشالی
ಪ್ರಗನ್ಯಾ	برجنیا
ಪ್ರಗಿತ	برجیت
ಪ್ರಚೀತೀ	برتشیتی
ಪ್ರಜೀಶಾ	برجیشا
ಪ್ರದಿಪಾ	بردیبا
ಪ್ರದೀಪ್ತಾ	بردیبتا
ಪ್ರನಾವಾಶ್ರೀ	برناواشری
ಪ್ರನಿತಾ	برنیتا
ಪ್ರನೀಕಾ	برنیكا
ಪ್ರಭಂಜನ	بربهنجن
ಪ್ರಭಾಕರ	بربهاكر
ಪ್ರಭಾದಾ	بربهادا
ಪ್ರಮಿಕಾ	برمیكا
ಪ್ರಹಾರ್ಶೀನೀ	برهارشینی
ಪ್ರಹಾಸಾ	برهاسا
ಪ್ರಾನಲ	برانل
ಫಣೀಶ	بهنیش
ಫ಼ಾಲ್ಗುನ	بهالجون
ಫುಲ್ಲಾರಾ	بهوللارا
ಬಂದನಾ	بندنا
ಬಂಧೀನೀ	بندهینی
ಬಂಸೀಲಾಲ	بنسیلال
ಬಖ್ತಾವರ	بكهتاور
ಬಗ್ಯಾರಾಜ	بجیاراج
ಬನಬಿಹಾರೀ	بنبیهاری
ಬರ್ಷಾ	برشا
ಬಲರಾಮ	بلرام
ಬಲವಾನ	بلوان
ಬಲಾದೀತ್ಯ	بلادیتی
ಬವೀಶ್ಯಸರೀ	بویشیسری
ಬಹವಾಸ್ಯ	بهواسی
ಬಹುಲಾ	بهولا
ಬಹುಲೇಯನ	بهولیین
ಬಾಂಕೇ ಬಿಹಾರೀ	بانكي بیهاری
ಬಾಜೀನಾಥ	باجیناته
ಬಾನೀ	بانی
ಬಾಪು	بابو
ಬಾಲಗೋಪಾಲ	بالجوبال
ಬಾಲಚಂದ್ರಾ	بالتشندرا
ಬಾಲನಾಥ	بالناته
ಬಾಲಾಜೀ	بالاجی
ಬಾಲಾರವೀ	بالاروی
ಬಿಂದುಮಾಲಿನೀ	بیندومالینی
ಬಿಂದೂಸರ	بیندوسر
ಬಿಜೋಯ	بیجوی
ಬಿನೋದ	بینود
ಬಿಪಾಶಾ	بیباشا
ಬಿಮ್ಬಾ	بیمبا
ಬಿರಂಚೀ	بیرنتشی
ಬಿಲ್ವಾ	بیلوا
ಬೀದಯುಂತ	بیدیونت
ಬೀನೋದೀನೀ	بینودینی
ಬೀನ್ಕಾಲ	بینكال
ಬೀಭು	بیبهو
ಬೀರಾತ	بیرات
ಬುದ್ಧ	بودده
ಬುದ್ಧಿ	بوددهی
ಬೇನುಂ	بینون
ಬೇನ್ನೀ	بیننی
ಬೇನ್ಶಿಕ	بینشیك
ಬೇಲುರಮೀ	بیلورمی
ಬೈರ	بایر
ಬೈಸಾಖೀ	بایساكهی
ಬೋನಾಸರೀ	بوناسری
ಬ್ರಹ್ಮಾವತೀ	برهماوتی
ಬ್ರೀಜಲ	بریجل
ಬ್ರೀನ್ದಾವಾನೀ	برینداوانی
ಬ್ಲೇಸ್ಸೀ	بلیسسی
ಭಕ್ತಿ	بهكتی
ಭಗವತೀ	بهجوتی
ಭದ್ರಕ	بهدرك
ಭದ್ರಕ್ಷ	بهدركش
ಭದ್ರಾ	بهدرا
ಭದ್ರೀಶಾ	بهدریشا
ಭವಾನಿದಾಸ	بهوانیداس
ಭವಿಷ್ಯಾ	بهویشیا
ಭವೀಶ	بهویش
ಭವ್ಯ	بهوی
ಭಾಗವಾಥ	بهاجواته
ಭಾಗಿರತ	بهاجیرت
ಭಾಗ್ಯವತೀ	بهاجیوتی
ಭಾಗ್ಯಶ್ರೀ	بهاجیشری
ಭಾಗ್ಯಾ	بهاجیا
ಭಾತ್ರಶ್ರೀ	بهاترشری
ಭಾದ್ರಿಕಾ	بهادریكا
ಭಾನುಜ	بهانوج
ಭಾನುದಾಸ	بهانوداس
ಭಾನುಪ್ರಿಯಾ	بهانوبرییا
ಭಾರನೀಧಾರ	بهارنیدهار
ಭಾರೂಕ	بهاروك
ಭಾರ್ತಿಹಾರೀ	بهارتیهاری
ಭಾವತೀ	بهاوتی
ಭಾವಾಥಾರೀನೀ	بهاواتهارینی
ಭಾವಾಪ್ರಿಯಾ	بهاوابرییا
ಭಾವಿಕ	بهاویك
ಭಾವಿತಾ	بهاویتا
ಭಾವೀಶಾ	بهاویشا
ಭಾವ್ಯಶ್ರೀ	بهاویشری
ಭಾಶ್ವೀನೀ	بهاشوینی
ಭಾಸ್ಕರಣ	بهاسكرن
ಭಾಸ್ಕೇರ	بهاسكیر
ಭಿಮಾಂಬಾಲಾ	بهیمانبالا
ಭೀಮ	بهیم
ಭೀಷಮ	بهیشم
ಭೀಷ್ಮ	بهیشم
ಭುವಿಕ	بهوویك
ಭೂತೇಶ್ವರ	بهوتیشور
ಭೂಪಾಲ	بهوبال
ಭೂಪಾಲೀ	بهوبالی
ಭೂಪೇನ	بهوبین
ಭೂಮತ	بهومت
ಭೂಮಿಕಾ	بهومیكا
ಭೇರವೀ	بهیروی
ಭೇರೇಶ	بهیریش
ಭೋಲಾನಾಥ	بهولاناته
ಭ್ರೀಜ	بهریج
ಮಂಜುಶ್ರೀ	منجوشری
ಮಂತವ್ಯ	منتوی
ಮಂದಾರ	مندار
ಮಂದಿನ	مندین
ಮಂದೀಪಾ	مندیبا
ಮಂಶಾ	منشا
ಮಕರ	مكر
ಮಣಿಕಾಂತ	منیكانت
ಮಣಿಮಾಲಾ	منیمالا
ಮಣಿಶಂಕರ	منیشنكر
ಮದುರಾ	مدورا
ಮಧುಜಾ	مدهوجا
ಮಧುರಾನೀ	مدهورانی
ಮಧುಲಿಕಾ	مدهولیكا
ಮಧುಶಾ	مدهوشا
ಮನನಶ	مننش
ಮನಸ್ವೀ	منسوی
ಮನಹರ	منهر
ಮನಾಗೋಬೀನದಾ	مناجوبیندا
ಮನಾಲೀ	منالی
ಮನಿಕುನ್ತಾಲಾ	منیكونتالا
ಮನಿರಾಮ	منیرام
ಮನಿಶಿಕಾ	منیشیكا
ಮನೀದೀಪ	منیدیب
ಮನೀಬಲನ	منیبلن
ಮನೀಷಾ	منیشا
ಮನೋಜವಾಯಾ	منوجوایا
ಮನೋರಥ	منورته
ಮನೋಹರಣ	منوهرن
ಮನ್ನನ	مننن
ಮನ್ವೀರ	منویر
ಮರಲಾ	مرلا
ಮಲಯಾ	ملیا
ಮಲಿಕಾ	ملیكا
ಮಲೀಂಗಾ	ملینجا
ಮಲ್ಕಾ	ملكا
ಮಹಂತ	مهنت
ಮಹಾಕಾಲ	مهاكال
ಮಹಾಗಂಗಾ	مهاجنجا
ಮಹಾತ್ಮಾ	مهاتما
ಮಹಾತ್ರೂ	مهاترو
ಮಹಾನ್ಯ	مهانی
ಮಹಾಬಲಾ	مهابلا
ಮಹಾಬಾಲಾ	مهابالا
ಮಹಾಬುದ್ಧಿ	مهابوددهی
ಮಹಾಲಕ್ಷ್ಮೀ	مهالكشمی
ಮಹಿರಂಶ	مهیرنش
ಮಹೀಧೇರ	مهیدهیر
ಮಹುಬಾಲಾ	مهوبالا
ಮಾಂಧುಘನೇ	ماندهوجهني
ಮಾಂಧುವೇಮಾನ	ماندهوویمان
ಮಾಂನಾಶ್ಯುಂ	مانناشیون
ಮಾಂನುರಾಈ	ماننوراإ
ಮಾಂನೋತ	ماننوت
ಮಾಂಮೋನ	مانمون
ಮಾಇಲ	ماإل
ಮಾಗತ	ماجت
ಮಾಗಧೀ	ماجدهی
ಮಾತನ	ماتن
ಮಾಧವನ	مادهون
ಮಾಧುಜ	مادهوج
ಮಾಧುರೀ	مادهوری
ಮಾಧುರ್ಯ	مادهوری
ಮಾನಸ್ವೀತಾ	مانسویتا
ಮಾನ್ಮಾತನ	مانماتن
ಮಾನ್ವಿತ	مانویت
ಮಾಯರಾ	مایرا
ಮಾರೀರಾಜ	ماریراج
ಮಾರುತ	ماروت
ಮಾರೂತ	ماروت
ಮಾರ್ಗಶೀ	مارجشی
ಮಾಲವ	مالو
ಮಾಲಾರ್ಕೋಡೀ	مالاركودی
ಮಾಲ್ಲೇಶಾ	ماللیشا
ಮಾಹಿತ	ماهیت
ಮೇಧೀನೀ	میدهینی
ಯಂಶ	ینش
ಯಜನ	یجن
ಯಜುಸ	یجوس
ಯದುನಂದನ	یدونندن
ಯಶಸ್ವಿನೀ	یشسوینی
ಯಶಾಲ	یشال
ಯಶುಸ	یشوس
ಯಶೋದಾಗರ್ಬಾ ಸಮ್ಭೂತಾ	یشوداجربا سمبهوتا
ಯಶ್ಯಾಸ್ಸರೀ	یشیاسسری
ಯಶ್ವಾರ್ಧಾನಾ	یشواردهانا
ಯಾಗ್ನೀಥಾ	یاجنیتها
ಯಾದ್ನ್ಯೇಶ	یادنییش
ಯಾಮಾಜೀತ	یاماجیت
ಯಾಲೀನೀ	یالینی
ಯಾಲೀಸಾಈ	یالیساإ
ಯಾಶೀನೀ	یاشینی
ಯಾಶ್ವನ	یاشون
ಯುಕ್ತಾತಮಾಂ	یوكتاتمان
ಯುಗಲ	یوجل
ಯುಗಾಂಕ	یوجانك
ಯುಗಾನ್ಧರ	یوجاندهر
ಯುಗ್ಮ	یوجم
ಯುಥಿಕಾ	یوتهیكا
ಯುಧಾವ	یودهاو
ಯುಧ್ಧ	یودهده
ಯುವಾಕ್ಷೀ	یوواكشی
ಯುವಾನೀ	یووانی
ಯುವೀ	یووی
ಯುವೀನ	یووین
ಯುಸು	یوسو
ಯೇಶಾಸ್ವೀ	ییشاسوی
ಯೇಶ್ವೀ	ییشوی
ಯೇಸ್ವಂಠ	ییسونطه
ಯೋಗದಾ	یوجدا
ಯೋಗಲಕ್ಷ್ಮೀ	یوجلكشمی
ಯೋಗಾ	یوجا
ಯೋಗೀ ಶ್ರೀ	یوجی شری
ಯೋಗೀಸಾಇ	یوجیساإ
ಯೋಗ್ದೀಪ	یوجدیب
ಯೋಗ್ರಾಮ	یوجرام
ಯೋನಿತಾ	یونیتا
ಯೋಹನ	یوهن
ರಂಗೀತ	رنجیت
ರಂಗೇಶ	رنجیش
ರಂತೀಕಾ	رنتیكا
ರಕ್ತ	ركت
ರಕ್ಷಾತೀ	ركشاتی
ರಕ್ಷಾನಾ	ركشانا
ರಕ್ಷ್ಯ	ركشی
ರಘುನನ್ದನ	رجهونندن
ರಘುಪತಿ	رجهوبتی
ರಘುಪ್ರಿಯಾ	رجهوبرییا
ರಚನಾ	رتشنا
ರಣಜೀ	رنجی
ರಣವಿಜಯ	رنویجی
ರತಿಕಾ	رتیكا
ರತ್ನಕುಂಡಲ	رتنكوندل
ರತ್ನಾಲೀ	رتنالی
ರತ್ನೇಶ	رتنیش
ರಥನಾ	رتهنا
ರನಾಮೀತಾ	رنامیتا
ರನ್ಯ	رنی
ರಮಾ  ದೇವೀ	رما  دیوی
ರಮಾಕಾಂತ	رماكانت
ರಮಿಲಾ	رمیلا
ರಮೋಲಾ	رمولا
ರವಿಕೀರ್ತೀ	رویكیرتی
ರವಿಚಂದ್ರ	رویتشندر
ರವಿಜ	رویج
ರವಿತಾ	رویتا
ರವಿನಾ	روینا
ರವಿಶಂಕರ	رویشنكر
ರವೀಂದ್ರ	رویندر
ರಶೀಕಾ	رشیكا
ರಶ್ಮೀ	رشمی
ರಶ್ಮೀಸ್ರಯಾ	رشمیسریا
ರಸರಾಜ	رسراج
ರಸಿಕಾ	رسیكا
ರಾಗಾ	راجا
ರಾಗಾವೀ	راجاوی
ರಾಗಾವೀನೋದೀನೀ	راجاوینودینی
ರಾಜಕುಮಾರೀ	راجكوماری
ರಾಜನ	راجن
ರಾಜಬೀರ	راجبیر
ರಾಜವೀ	راجوی
ರಾಜಸೇಕರಣ	راجسیكرن
ರಾಜಾಹಮ್ಸನ	راجاهمسن
ರಾಜೀ	راجی
ರಾಜ್ಕಲಾ	راجكلا
ರಾಜ್ಬಲಾ	راجبلا
ರಾತ್ನಾನೀಧೀ	راتنانیدهی
ರಾಧೇಯಾ	رادهییا
ರಾನಾ	رانا
ರಾಮಚರಣ	رامتشرن
ರಾಮರಾಜ	رامراج
ರಾಮಸುಂದರ	رامسوندر
ರಾಮಾದೀಪ	رامادیب
ರಾಯಂಶ	راینش
ರಾಷೀಪ	راشیب
ರಾಸ್ಯಾ	راسیا
ರಿಶಿಮಾ	ریشیما
ರಿಹಾನ	ریهان
ರೀಅನಾ	ریانا
ರೀತಮಾಂ	ریتمان
ರೀತ್ಶೀಕಾ	ریتشیكا
ರೀಥೀಶಾ	ریتهیشا
ರೀಥ್ವೀ	ریتهوی
ರೀದ್ಧೀಮಾಂ	ریددهیمان
ರೀನ್ಸೀನ	رینسین
ರೀಮೀ	ریمی
ರೀಶಾನೀ	ریشانی
ರೀಶೋನಾ	ریشونا
ರೀಸ್ಲುಂನಾ	ریسلوننا
ರೂಂಗ / ರಂಗ	رونج / رنج
ರೇಡ್ಡೀ	ریددی
ರೇಥುಶಾನಾ	ریتهوشانا
ರೇನುಕ	رینوك
ರೇಭಾ	ریبها
ರೇಮಾಂನೀಕಾ	ریماننیكا
ರೇಮ್ಯಾ	ریمیا
ರೇವಂತ	ریونت
ರೇಶಿಕಾ	ریشیكا
ರೇಹಾ	ریها
ರೇಹ್ನುಘಾ	ریهنوجها
ಲಕೀ	لكی
ಲಕ್ಷಾಕೀ	لكشاكی
ಲಕ್ಷಿತಾ	لكشیتا
ಲಕ್ಷ್ಮಣಅಪರಣದಾತಾ	لكشمنابرنداتا
ಲಕ್ಷ್ಮೀ	لكشمی
ಲಕ್ಷ್ಮೀ   ನಾರಾಯಣ	لكشمی   ناراین
ಲಕ್ಷ್ಮೀನ	لكشمین
ಲಖಿತ	لكهیت
ಲಜ್ಜಕ	لججك
ಲಜ್ಜಾ	لججا
ಲತಾಕಾರಾ	لتاكارا
ಲಯನಾ	لینا
ಲಲಿತಾದಿತ್ಯ	للیتادیتی
ಲವಂಗೀ	لونجی
ಲವನಾ	لونا
ಲವಲೀನ	لولین
ಲವಾಮ	لوام
ಲಾಥಾನಗೀ	لاتهانجی
ಲಾಬನ್ಯ	لابنی
ಲಾಬುಕೀ	لابوكی
ಲಾಭಾ	لابها
ಲಾರ್ಮಿಕಾ	لارمیكا
ಲಾಲಸಾ	لالسا
ಲಾಲಾತೇಂದು	لالاتیندو
ಲಾವನ್ತೀಕಾ	لاونتیكا
ಲಾವಾಲಿಕಾ	لاوالیكا
ಲಾಸ್ಯಾವೀ	لاسیاوی
ಲಿಖಿತ	لیكهیت
ಲಿಮಿಯಾ	لیمییا
ಲೀಗ	لیج
ಲೀತೀಶಾ	لیتیشا
ಲೀನಾಥಾ	لیناتها
ಲೀನೀತ	لینیت
ಲೀನ್ಗದೇವಾರುಂ	لینجدیوارون
ಲೀನ್ಗರಾಜಾ	لینجراجا
ಲೀನ್ಗೀಃ	لینجیها
ಲೀಪಿಕಾ	لیبیكا
ಲೀಲಾಮಈ	لیلامإ
ಲೀಲಾವತೀ	لیلاوتی
ಲೀಶಾ	لیشا
ಲುಕೇಶ	لوكیش
ಲುಪೇಶ	لوبیش
ಲೇಈಶಾ	لیإشا
ಲೇಕ್ಯಾ	لیكیا
ಲೇಕ್ಷಾನಾ	لیكشانا
ಲೇಖಕ	لیكهك
ಲೇಖೀಶಾ	لیكهیشا
ಲೋಕಪ್ರಕಾಶ	لوكبركاش
ಲೋಕಾಕೃತಿ	لوكاكرتی
ಲೋಕಾಜನಾನೀ	لوكاجنانی
ಲೋಕಾಧ್ಯಕ್ಷ	لوكادهیكش
ಲೋಕ್ಭುಶನ	لوكبهوشن
ಲೋಕ್ಷೀ	لوكشی
ಲೋಗಚಾನ್ದ್ರಣ	لوجتشاندرن
ಲೋಗನ	لوجن
ಲೋಗನಾಥನ	لوجناتهن
ಲೋಗೀನೀ	لوجینی
ಲೋಗೇಶ	لوجیش
ಲೋನಾ	لونا
ಲೋಮಶ	لومش
ಲೋಮಾಂಕೇಶ	لومانكیش
ಲೋಲೀಥ್ಯಾ	لولیتهیا
ಲೋವೇಯಂಶ	لوویینش
ಲೋಶೀನೀ	لوشینی
ಲೋಹೀತಾ	لوهیتا
ಲೋಹೀತ್ಸರಣ	لوهیتسرن
ವಂಶಿಕಾ	ونشیكا
ವಕ್ರತುನ್ಡಾ	وكرتوندا
ವಕ್ಷ	وكش
ವಚನ	وتشن
ವತ್ಸಲಾ	وتسلا
ವರಲಕ್ಷ್ಮೀ	ورلكشمی
ವರ್ದಾನೀ	وردانی
ವರ್ಧಾನೀ	وردهانی
ವರ್ನೀಥಾ	ورنیتها
ವರ್ಷಾನ	ورشان
ವಲ್ಲಭೀ	وللبهی
ವಶೀತಾ	وشیتا
ವಸತೀನ	وستین
ವಸಾ	وسا
ವಸೀಸತಾ	وسیستا
ವಸುಧಾ	وسودها
ವಸುಮಿತ್ರ	وسومیتر
ವಸುರೂಪ	وسوروب
ವಸುಶ	وسوش
ವಸ್ಥಾವೀ	وستهاوی
ವಹೀಂ	وهین
ವಾಕ್ಶಾನಾ	واكشانا
ವಾಗ್ಮೀನ	واجمین
ವಾಜ್ರಕ್ಷ	واجركش
ವಾಜ್ರನಾಖಾ	واجرناكها
ವಾತ್ಸಲ್ರಾಜ	واتسلراج
ವಾದಿವೇಲನ	وادیویلن
ವಾದಿವೇಲುಂ	وادیویلون
ವಾದೀರಾಜ	وادیراج
ವಾನಿಶ್ರೀ	وانیشری
ವಾನುಜಾ	وانوجا
ವಾಮನ	وامن
ವಾಮಾಂಕ್ಷೀ	وامانكشی
ವಾಮಿಲ	وامیل
ವಾಮ್ಶೀಥಾ	وامشیتها
ವಾಯಾ	وایا
ವಾಯು	وایو
ವಾಸನ	واسن
ವಾಸು	واسو
ವಾಸುಮಾಂಥಾ	واسومانتها
ವಿಅರ	ویار
ವಿಕ್ಟೋರಿಯಾ	ویكطورییا
ವಿಕ್ರಾಂತಿ	ویكرانتی
ವಿಜಯಾಲಕ್ಷ್ಮೀ	ویجیالكشمی
ವಿಜೀತಾ	ویجیتا
ವಿಜುಲ	ویجول
ವಿದಿಶಾ	ویدیشا
ವಿದ್ವಾಥ	ویدواته
ವಿನತಿ	وینتی
ವಿನಸ	وینس
ವಿನಾ	وینا
ವಿನಾಥೀ	ویناتهی
ವಿನಾಯಿಕಾ	ویناییكا
ವಿನ್ದ್ಯಾ	ویندیا
ವಿಭಾಸ	ویبهاس
ವಿಭೀ	ویبهی
ವಿಭೂಷ	ویبهوش
ವಿಮಲಾ	ویملا
ವಿರಬಾಬು	ویربابو
ವಿಲಾಸಿನೀ	ویلاسینی
ವಿಹಾನೀ	ویهانی
ವಿಹಾರಿಕಾ	ویهاریكا
ವೀಅಲಾಶೀನೀ	ویالاشینی
ವೇಂಕಟ ಮಾನೀ	وینكط مانی
ವೇತ್ರೀ	ویتری
ವೇದನ್ಜಾನಾ	ویدنجانا
ವೇದಾಂಗ	ویدانج
ವೇದಾತ್ಮನೇ	ویداتمني
ವೇದಾಸ್ವರೂಪೀ	ویداسوروبی
ವೇದೀಥಾ	ویدیتها
ವೇದ್ವಿಯನ	ویدویین
ವೇಧಾವಲ್ಲೀ	ویدهاوللی
ವೇನಮಾಂಥೀ	وینمانتهی
ವೇನಾ	وینا
ವೇನೀ	وینی
ವೇನ್ಕಟಾಗೀರೀ	وینكطاجیری
ವೇನ್ಕಟೇಶಾ	وینكطیشا
ವೇನ್ಕನಾ	وینكنا
ವೇಲ್ಕ್ಯ	ویلكی
ವೇವೇಶಾ	ویویشا
ವೈಗಾ	وایجا
ವೈಜಯಂತೀ	وایجینتی
ವೈಜಯೀ	وایجیی
ವೈದಿಕ	وایدیك
ವೈದೀಕಾ	وایدیكا
ವೈಧೇ	وایدهي
ವೈಧ್ಯಾತ	وایدهیات
ಶೈಲೇಶ	شایلیش
ಸಂಗಮ	سنجم
ಸಂಗೀತಾ	سنجیتا
ಸಂಚಾನಾ	سنتشانا
ಸಂಜಾಣಥೀ	سنجانتهی
ಸಂಜೀವ	سنجیو
ಸಂಜೀವೀ	سنجیوی
ಸಂಜುಕ್ಥಾ	سنجوكتها
ಸಂಥೀನೀ	سنتهینی
ಸಂದೀಪ್ತಾ	سندیبتا
ಸಂಧರಾ	سندهرا
ಸಂಪದಾ	سنبدا
ಸಂಮತ	سنمت
ಸಕ್ಥೀದಾರ	سكتهیدار
ಸಖಾ	سكها
ಸಗ್ನೀಕ	سجنیك
ಸಚ್ಚಿತ	ستشتشیت
ಸಚ್ಚಿದಾನಂದ ವಿಗ್ರಹ	ستشتشیدانند ویجره
ಸಜೂ	سجو
ಸದಗತಾ	سدجتا
ಸನಾತನ	سناتن
ಸನಾಥ	سناته
ಸಫ಼ಲಾ	سبهلا
ಸಫ್ಫರ	سبهبهر
ಸಬರಿಶ	سبریش
ಸಬಿತಾ	سبیتا
ಸಮಕ್ಷ	سمكش
ಸಮಜ	سمج
ಸಮನ್ಯು	سمنیو
ಸಮಬರಣ	سمبرن
ಸಮಭಾವನ	سمبهاون
ಸಮಾಂನ್ವಿತಾ	سماننویتا
ಸಮಾಂಶ್ರಯ	سمانشری
ಸಮಿಕ	سمیك
ಸಮೀರ	سمیر
ಸಮೀರಾ	سمیرا
ಸಮುದಾಯ	سمودای
ಸಮುದ್ರಾ	سمودرا
ಸಮೇಂದು	سمیندو
ಸಮ್ಪ್ರಸಾದ	سمبرساد
ಸಮ್ಪ್ರಿತೀ	سمبریتی
ಸಮ್ಬತ	سمبت
ಸಮ್ಮಾದ	سمماد
ಸಮ್ಯಕ	سمیك
ಸಮ್ಶೀನೀ	سمشینی
ಸಮ್ಸ್ಕಾರಾ	سمسكارا
ಸಮ್ಹೀಠಾ	سمهیطها
ಸರಜಾ	سرجا
ಸರಿಶಾ	سریشا
ಸರ್ಗಿನೀ	سرجینی
ಸಹಶ್ರದ	سهشرد
ಸಾಈ ಅರ್ಜುನ	ساإ ارجون
ಸಾಈ ಶ್ರೀ	ساإ شری
ಸಾಈ ಸತ್ಪುರುಷಾ	ساإ ستبوروشا
ಸಾಈ ಸುರಿಯಾ	ساإ سورییا
ಸಾತ್ವಿಕ	ساتویك
ಸಾತ್ವಿಕಾ	ساتویكا
ಸಾದರೀ	سادری
ಸಾದ್ವಿಥಾ	سادویتها
ಸಾಧ್ಯ	سادهی
ಸಾನಾವೀ	ساناوی
ಸಾಬೀತ್ರೀ	سابیتری
ಸಾಮಂತ	سامنت
ಸಾಮೋದ	سامود
ಸಾಮ್ರೀನ	سامرین
ಸಾಯರಾಮ	سایرام
ಸಾರಂಗೀ	سارنجی
ಸಾರಸೀ	سارسی
ಸಾರಾನ್ಯ	سارانی
ಸಾರಾಹ	ساراه
ಸಾವಿತ್ರ	ساویتر
ಸೈಕತ	سایكت
ಸೈಜಾಸೀ	سایجاسی
ಸೈನಿ	ساینی
ಸೈನೀತ್ಯ	ساینیتی
ಸೈನ್ಧಾವ	سایندهاو
ಹಂಸಾ	هنسا
ಹಂಸಿನ	هنسین
ಹಂಸ್ಧ್ವಾನೀ	هنسدهوانی
ಹಜೇಶ	هجیش
ಹನೀತಾ	هنیتا
ಹನೀಮಾ	هنیما
ಹನೀಶ್ಕಾ	هنیشكا
ಹಮಸಾನಂದೀನೀ	همسانندینی
ಹಯಾತೀ	هیاتی
ಹರನೀಶ	هرنیش
ಹರಿಅಕ್ಸಾ	هریاكسا
ಹರಿಕಿಶನ	هریكیشن
ಹರಿತ	هریت
ಹರಿದಾ	هریدا
ಹರಿದಾಸ	هریداس
ಹರಿನ್ದ್ರನಾಥ	هریندرناته
ಹರಿಪ್ರಸಾದ	هریبرساد
ಹರಿವಂಶ	هریونش
ಹರೀಜ	هریج
ಹರೀಥ್ರಾ	هریتهرا
ಹರೀಧಾಮ	هریدهام
ಹರೀಮಾಂರ್ಕಾತಾಮಾಂರ್ಕತಾ	هریمانركاتامانركتا
ಹರೀಶ್ರೀ	هریشری
ಹರೀಸಾಈ	هریساإ
ಹರೇಕೃಷ್ಣ	هریكرشن
ಹರ್ಕೇಶ	هركیش
ಹರ್ಥೀಕಾ	هرتهیكا
ಹರ್ಯಾಕ್ಷಾ	هریاكشا
ಹರ್ಲೇಯ	هرلیی
ಹರ್ಶಾಶ್ರೀ	هرشاشری
ಹರ್ಷವರ್ದನ	هرشوردن
ಹರ್ಷಿತ	هرشیت
ಹವೀಹ	هویه
ಹಶ್ವರ್ಧನ	هشوردهن
ಹಸಂತ	هسنت
ಹಾಕೇಶ	هاكیش
ಹಾರ್ಶೀನೀ	هارشینی
ಹಾಸಂಥೀ	هاسنتهی
ಹಿಡಿಂಬಾ	هیدینبا
ಹಿತಾಂಶು	هیتانشو
ಹಿತಾಂಸೀ	هیتانسی
ಹಿತೀ	هیتی
ಹಿತೀಕ್ಷಾ	هیتیكشا
ಹಿತೇನ್ದ್ರ	هیتیندر
ಹಿತೈಷೀ	هیتایشی
ಹಿಥೀಕ್ಸಾ	هیتهیكسا
ಹಿಮವಂತ	هیمونت
ಹಿಮಾಂಕ	هیمانك
ಹಿಮಾಂನಿಶ	هیماننیش
ಹಿಮಾಂನ್ಗೀನೀ	هیماننجینی
ಹಿಮಾಂಸೇಖರ	هیمانسیكهر
ಹಿಮಾದ್ರೀ	هیمادری
ಹಿಮಾನ್ಸು	هیمانسو
ಹಿಯಾ	هییا
ಹಿಲೀ	هیلی
ಹೀಥಾ	هیتها
ಹೀಮೀರ	هیمیر
ಹುಮೀಶಾ	هومیشا
ಹುವೇನ್ದ್ರ	هوویندر
ಹೇತ	هیت
ಹೇತವ	هیتو
ಹೇತಾಂಶೀ	هیتانشی
ಹೇತ್ವಿಕ	هیتویك
ಹೇಥಾನ್ಶ್ರೀ	هیتهانشری
ಹೇನಾ	هینا
ಹೇನೀತ	هینیت
ಹೇನ್ಸೀ	هینسی
ಹೇಮ ಲಥಾ	هیم لتها
ಹೇಮಚಂದರ	هیمتشندر
ಹೇಮಾಕೇಶ	هیماكیش
ಹೇಮೀತಾ	هیمیتا
ಹೇಮೀತ್ರಾ	هیمیترا
ಹೇಮೀನ	هیمین
ಹೇಮೇಂದ್ರ	هیمیندر
ಹೇರಕ	هیرك
ಹೇರೀ	هیری
ಹೇಲಸಾ	هیلسا
ಹೇಲಾ	هیلا
ಹೇಲ್ಲ್ಯ	هیللی
ಹೋಜನ	هوجن
ಹೋಯಲಾ	هویلا
ಹ್ರೀತೀಕಾ	هریتیكا
ಹ್ರೀದೇಶ	هریدیش
ಹ್ರೀದ್ಯೇಸಾ	هریدییسا
ಹ್ರೀಶನ	هریشن
