# Baby names
ଅକର୍ଯସୁଟ	اكریسوط
ଅଚଲା	اتشلا
ଅଚିଟ୍	اتشیط
ଅଦିତା	ادیتا
ଅଦ୍ବୈଯା	ادباییا
ଅଫ୍ର	ابهر
ଅବିଶ	ابیش
ଅବ୍ଭିନବ୍	اببهینب
ଅଭିନତ	ابهینت
ଅଭିନିତି	ابهینیتی
ଅଭିପ୍ରିତି	ابهیبریتی
ଅଭିମନି	ابهیمنی
ଅଭିରତି	ابهیرتی
ଅଭିସର୍	ابهیسر
ଆଅଶ୍ନା	آاشنا
ଆଇଶ୍	آإش
ଆଗନେଯ	آجنیی
ଆଗନେୟା	آجنییا
ଆଘନ୍ୟା	آجهنیا
ଆଟିଶ୍	آطیش
ଆଡିତ୍	آدیت
ଆଡ୍ରିଟି	آدریطی
ଆତ୍ମିକ	آتمیك
ଆଦବିକା	آدبیكا
ଆଦିନାଥ୍	آدیناته
ଆଧାବ୍	آدهاب
ଆନଗଟ୍	آنجط
ଆନନ୍ଦସ୍ବରୁପ୍	آنندسبروب
ଆନଶଲ୍	آنشل
ଆନାଲ୍	آنال
ଆପଟ୍	آبط
ଆମୁକଥା	آموكتها
ଆଯୁ	آیو
ଆରଣା	آرنا
ଆରଥ୍	آرته
ଆରବ୍	آرب
ଆରଭି	آربهی
ଆରିଟ୍	آریط
ଆରୁନା	آرونا
ଆରୁଶା	آروشا
ଆର୍ଥୀ	آرتهی
ଆର୍ନବ୍	آرنب
ଆରୟାନ୍	آریان
ଆରୟାମନ୍	آریامن
ଆଲିୟଃ	آلییها
ଆଶାଲତା	آشالتا
ଆସ୍ତ	آست
ଆସ୍ମି	آسمی
ଇକ୍ଶିତା	إكشیتا
ଇଟନ୍	إطن
ଇଡିକା	إدیكا
ଇନକନ୍ଟା	إنكنطا
ଇନିଯବନ୍	إنییبن
ଇନେଶ୍	إنیش
ଇନ୍ଡରେଶ୍	إندریش
ଇନ୍ଡୁକାନ୍ଟ୍	إندوكانط
ଇନ୍ଡୁଜ୍	إندوج
ଇନ୍ଡ୍ରଯନି	إندرینی
ଇପ୍ସିଟା	إبسیطا
ଇବାନ୍କା	إبانكا
ଇଭ୍ଯା	إبهیا
ଇମ୍ପାଲ୍	إمبال
ଇମ୍ଲା	إملا
ଇରାନା	إرانا
ଇରେନ୍ପ୍ରୀଟ୍	إرینبریط
ଇଲବେନିଲ୍	إلبینیل
ଇଲିଶା	إلیشا
ଇଶା କ୍ରିଟିକ୍	إشا كریطیك
ଇଶି	إشی
ଇଶିର୍	إشیر
ଇସାଇଅରାସୁ	إساإاراسو
ଇସ୍ଶୁ	إسشو
ଇହା	إها
ଇହାମ୍	إهام
ଈଶାନି	إشانی
ଉଜାଲା	وجالا
ଉଜ୍ଜାନିନି	وججانینی
ଉଟନ୍କା	وطنكا
ଉଟ୍କର୍ଶା	وطكرشا
ଉଡାନ୍ଟିକା	ودانطیكا
ଉଡିଶା	ودیشا
ଉଡେଯ୍	ودیی
ଉଡ୍ଡିଶ୍	وددیش
ଉଡ୍ଯମ୍	ودیم
ଉତାମି	وتامی
ଉତିରା	وتیرا
ଉନ୍ନତିଶ୍	وننتیش
ଉନ୍ନଭ୍	وننبه
ଉନ୍ନିକ୍ରିଶ୍ନନ୍	وننیكریشنن
ଉନ୍ମାଇବିଲମ୍ବି	ونماإبیلمبی
ଉପାନ୍ଶୁ	وبانشو
ଉପେନ୍ଡ୍ରା	وبیندرا
ଉପ୍ଜୀତ୍	وبجیت
ଉପ୍ମା	وبما
ଉମା	وما
ଉର୍ବଶି	وربشی
ଉର୍ବଶୀ	وربشی
ଉର୍ବିଶ୍	وربیش
ଉଶା ଲକ୍ଶି	وشا لكشی
ଉଶ୍ନିସିନ୍	وشنیسین
ଉସ୍ରି	وسری
ଊର୍ଜିଟ୍	ورجیط
ଏଇରାବଟି	یإرابطی
ଏକଚକ୍ରା	یكتشكرا
ଏକଚନ୍ଡ୍ର	یكتشندر
ଏକଚିତ୍	یكتشیت
ଏକବିରା	یكبیرا
ଏକଲିଙା	یكلینگا
ଏକ୍ଟା	یكطا
ଏକ୍ଲବ୍ଯ	یكلبی
ଏଗୈଅରସୁ	یجایارسو
ଏଡୋମ୍	یدوم
ଏଦସ୍	یدس
ଏରା	یرا
ଏଲବେନ୍ଦନ୍	یلبیندن
ଏଲିକା	یلیكا
ଏଲିଲ୍ବେନ୍ଡନ୍	یلیلبیندن
ଏଶଞା	یشنا
ଏଶନି	یشنی
ଏଶନ୍ଶ୍	یشنش
ଏଶ୍ନି	یشنی
ଏଶ୍ମା	یشما
ଓଜାସ୍ବୁଇଟା	اوجاسبوإطا
ଓଜାସ୍ବୁଇନି	اوجاسبوإنی
ଓବିଶ୍କର୍	اوبیشكر
ଓମାନା	اومانا
ଓମାର୍ଜୀଟ୍	اومارجیط
ଓମ୍ଜା	اومجا
ଓମ୍ଡୁଟ୍ଟ୍	اومدوطط
କଟେଲ୍ଯ୍ନ୍	كطیلین
କନକବଟି	كنكبطی
କନିସା	كنیسا
କନ୍ଡର୍ପା	كندربا
କନ୍ନକି	كننكہ
କନ୍ଶ୍	كنش
କନ୍ହୈଯାଲାଲ୍	كنہيیالال
କପିଲେଶ୍	كبیلیش
କପୀଶ୍	كبیش
କପୀଶ୍ବୁଅର୍	كبیشبوار
କବଲ୍	كبل
କବିତା	كبیتا
କବିନଯା	كبینیا
କମଲ୍ନଯନ୍	كملنین
କମେଶ୍ବୁଅର୍	كمیشبوار
କମୋଡ୍	كمود
କଯଲ୍ବିଲି	كیلبیلی
କରିଶ୍ମା	كریشما
କରୁନାକର୍	كروناكر
କରୋନା	كرونا
କର୍ଟାର୍	كرطار
କର୍ତି	كرتی
କର୍ତୀକ୍	كرتیك
କର୍ହିକ୍	كرهیك
କଲବତି	كلبتی
କଲୈଅରସି	كلایارسی
କଲ୍ପା	كلبا
କଲ୍ବା	كلبا
କଶିଶ୍	كشیش
କଶ୍ମିରା	كشمیرا
କସିଶ୍	كسیش
କସ୍ନି	كسنی
କସ୍ସମଲି	كسسملی
କହର୍	كهر
କହ୍ଲିମା	كهلیما
କାକଲି	كاكلی
କାକୋଲି	كاكولی
କାକ୍ଶା	كاكشا
କାଜୋଲ୍	كاجول
କାଡନ୍ମ୍ବରି	كادنمبری
କାନ୍ଟି	كانطی
କାଲିକା	كالیكا
କାଲିଚରନ୍	كالیتشرن
କାଲିନ୍ଡି	كالیندی
କାଲିଯା	كالییا
କାଲିରନ୍ଜନ୍	كالیرنجن
କୈରବ୍	كایرب
କୈଲାସ୍	كایلاس
କୌଶିକା	كاوشیكا
କୌଶ୍ଲେନ୍ଡେର୍	كاوشلیندیر
ଗଙାଡଟ୍ଟ୍	جنگادطط
ଗଙେଶ୍	جنگیش
ଗଜନନ	ججنن
ଗଜାନନ୍ଡ୍	ججانند
ଗଜ୍ରୁପ୍	ججروب
ଗନଦ୍ଯକ୍ଶିନା	جندیكشینا
ଗନରାଜ୍	جنراج
ଗମ୍ଭିର୍	جمبهیر
ଗରିଶିଟ୍	جریشیط
ଗରିଶ୍ଟ୍	جریشط
ଗରୁଡ୍	جرود
ଗାର୍ଗୀ	جارجی
ଗିଟାନ୍ଜଲି	جیطانجلی
ଗିଟିକା	جیطیكا
ଗିବ୍ସୋନ୍	جیبسون
ଗିରିଜନନ୍ଡନ୍	جیریجنندن
ଗିରିଶରନ୍	جیریشرن
ଗୀଟାନ୍ଜଲି	جیطانجلی
ଗୀଟାସ୍ରି	جیطاسری
ଗୀତିକା	جیتیكا
ଗୁନସେକରନ୍	جونسیكرن
ଗୁନିତା	جونیتا
ଗୁଫାମ୍	جوبهام
ଗୁରୁ	جورو
ଗୁରୁ ଗୁଗନ୍	جورو جوجن
ଗୁରୁସାରନ୍	جوروسارن
ଗେଯା	جییا
ଗୋଉରଙି	جوورنگی
ଗୋଟମ୍	جوطم
ଗୋଡବରି	جودبری
ଗୋପାଲ୍	جوبال
ଗୋପିନାତନ୍	جوبیناتن
ଗୋପୁ	جوبو
ଗୋବିଲ୍	جوبیل
ଗୋରଖ୍	جوركه
ଗୋଲୋଚନ୍	جولوتشن
ଗୌରଂଗୀ	جاورنجی
ଗ୍ନନଲିଆ	جننلیآ
ଗ୍ଯାନା	جیانا
ଗ୍ରହିଲ୍	جرهیل
ଗ୍ରିତେଶ୍	جریتیش
ଘନମଲିକା	جهنملیكا
ଘନଲିଙା	جهنلینگا
ଘୁଲିକା	جهولیكا
ଚଟୁର୍ଭୁଜା	تشطوربهوجا
ଚଟୁର୍ଭୁଜ୍	تشطوربهوج
ଚନ୍ଚଲା	تشنتشلا
ଚନ୍ଡା ବର୍ମନ୍	تشندا برمن
ଚନ୍ଡେର୍	تشندیر
ଚନ୍ଡ୍ରକାନ୍ଟା	تشندركانطا
ଚନ୍ଡ୍ରକିର୍ତି	تشندركیرتی
ଚନ୍ଡ୍ରଡିଟ୍ଯା	تشندردیطیا
ଚନ୍ଡ୍ରନାତ୍	تشندرنات
ଚନ୍ଡ୍ରପ୍ରକାଶ୍	تشندربركاش
ଚନ୍ଡ୍ରବାତି	تشندرباتی
ଚନ୍ଡ୍ରମୋଉଲି	تشندرموولی
ଚନ୍ଡ୍ରଲେଖା	تشندرلیكها
ଚନ୍ଡ୍ରସହୋଡରି	تشندرسهودری
ଚନ୍ଡ୍ରାକିରନ୍	تشندراكیرن
ଚନ୍ଡ୍ରେଯୀ	تشندرییی
ଚନ୍ଡ୍ର୍ପୀଡ୍	تشندربید
ଚମ୍ପା	تشمبا
ଚମ୍ପିକା	تشمبیكا
ଚରନ୍ଜୀଟ୍	تشرنجیط
ଚରନ୍ଡେବ୍	تشرندیب
ଚରିଟା	تشریطا
ଚରୁପ୍ରଭା	تشروبربها
ଚରୁଲେଖା	تشرولیكها
ଚରୁଶିଲା	تشروشیلا
ଚାଯା	تشایا
ଚିଟ୍ରିଟା	تشیطریطا
ଚିଡକଶ୍	تشیدكش
ଚିଡାନନ୍ଡ୍	تشیدانند
ଚିତ୍ରା	تشیترا
ଚିନ୍କଲ୍	تشینكل
ଚିନ୍ଟନା	تشینطنا
ଚିନ୍ଟନିକା	تشینطنیكا
ଚିନ୍ଟଲ୍	تشینطل
ଚିନ୍ମଯୁ	تشینمیو
ଚିରନ୍ଜିବ୍	تشیرنجیب
ଚିରନ୍ଜୀବି	تشیرنجیبی
ଚିରୁ	تشیرو
ଚୁଟ୍କି	تشوطكہ
ଚେଟକ୍	تشیطك
ଚେନ୍ନା	تشیننا
ଚେମ୍ମଲ୍	تشیممل
ଚେରିତ୍	تشیریت
ଚେଲନ୍	تشیلن
ଚେଲିଯନ୍	تشیلیین
ଚେଲୁବା	تشیلوبا
ଚୈଟ୍ରା	تشایطرا
ଚୈନ୍	تشاین
ଚୋଲାନ୍	تشولان
ଚ୍ହଯାନ୍କ୍	تشهیانك
ଜଗଟି	ججطی
ଜଗଟ୍ଗୁରୁ	ججطجورو
ଜଗଡମ୍ବିକା	ججدمبیكا
ଜଗଡ୍ବନ୍ଡୁ	ججدبندو
ଜଗନ୍ନାତନ୍	ججنناتن
ଜଗନ୍ମଯୀ	ججنمیی
ଜଗ୍ଜିବନ୍	جججیبن
ଜଗ୍ଜୀବନ୍	جججیبن
ଜନକିଭୁଶନ୍	جنكیبهوشن
ଜନଦର୍ନ୍	جندرن
ଜନାନି	جنانی
ଜନାର୍ଦନା	جناردنا
ଜମୁନା	جمونا
ଜଯ ପ୍ରଟୀକ୍	جی برطیك
ଜଯ ପ୍ରିଯା	جی برییا
ଜଯପୋର୍ନା	جیبورنا
ଜଯସ୍ରି	جیسری
ଜଯାନନ୍ଡ୍	جیانند
ଜଯ୍କିଶନ୍	جیكیشن
ଜଯ୍ସ୍ରୀ	جیسری
ଜଲକ୍	جلك
ଜଲନ୍ହିଲି	جلنهیلی
ଜଲ୍ଦର୍	جلدر
ଜଶି	جشی
ଜଶୋଡା	جشودا
ଜସମିଟ୍	جسمیط
ଜସ୍ବୁଇତା	جسبوإتا
ଜସ୍ମେର୍	جسمیر
ଜାଗ୍ରୁଟି	جاجروطی
ଜାନବି	جانبی
ଜାନ୍	جان
ଜାନ୍ଜର୍	جانجر
ଜାବିଅନ୍	جابیان
ଜାବେଶ୍	جابیش
ଜାହି	جاهی
ଜିଗନଶା	جیجنشا
ଜିଗ୍ଯାଶା	جیجیاشا
ଜିତ୍ଯା	جیتیا
ଜିନ୍ସ୍ଯ୍	جینسی
ଜିବଟି	جیبطی
ଜିଯା ଉଶସ୍	جییا وشس
ଜିଶା	جیشا
ଜୀବିଟା	جیبیطا
ଜୀବ୍ନୀ	جیبنی
ଜେନିଶା	جینیشا
ଜେନ୍ସ୍ଯ୍	جینسی
ଜେଯରଟ୍ନମ୍	جییرطنم
ଜେଲସ୍ମି	جیلسمی
ଜେସ୍ରି	جیسری
ଜେହନ୍ନଜ୍	جیهننج
ଜୈଚନ୍ଡ୍ରନ୍	جایتشندرن
ଜୈଟୈଶ୍	جایطایش
ଜୈଡଯାଲ୍	جایدیال
ଜୈନନ୍ଡ୍	جاینند
ଜୈନିଶ୍	جاینیش
ଜୈନେଶ୍	جاینیش
ଜୈବୀର୍	جایبیر
ଜୈବୁଅନ୍ଟ୍	جایبوانط
ଜୈମନ୍	جایمن
ଜୈଶନ୍କର୍	جایشنكر
ଜୈସୁଦନ୍	جایسودن
ଜୋଲ୍ଯ୍	جولی
ଝିନୁକ୍	جهینوك
ଝିଲ୍ମିଲ୍	جهیلمیل
ଟିଟିର୍	طیطیر
ଟିଲୋଟ୍ଟମା	طیلوططما
ଟିସ୍ଟା	طیسطا
ଟେଜସ୍ବୁଇନ୍	طیجسبوإن
ଟୋଶନ୍	طوشن
ଟ୍ରୈଲୋକ୍ବା	طرایلوكبا
ଡଦିଜା	ددیجا
ଡବୀଟ୍	دبیط
ଡାନିଶ୍	دانیش
ଣିଲାନ୍ଜନା	نیلانجنا
ତଙାଡୁରାଇ	تنگادوراإ
ତଙାମନି	تنگامنی
ତଙାରାଜ୍	تنگاراج
ତତ୍ବ	تتب
ତନଯ୍ମୀ	تنیمی
ତନିଆ	تنیآ
ତନିଗାଇ	تنیجاإ
ତନିଶ୍କ	تنیشك
ତନିଶ୍ତା	تنیشتا
ତନୁଜ୍	تنوج
ତନୋଜ୍	تنوج
ତନ୍ଶୁ	تنشو
ତପସ୍ଯା	تبسیا
ତବୁ	تبو
ତମୋଘ୍ନା	تموجهنا
ତରକାର୍ ସେର୍ରୋନ୍	تركار سیررون
ତରକ୍	ترك
ତରଶ	ترش
ତରାନିକା	ترانیكا
ତର୍ଜ୍ନି	ترجنی
ତର୍ପନ୍	تربن
ତର୍ଲି	ترلی
ତର୍ଶିନି	ترشینی
ତଶ୍ବି	تشبی
ତହାନ୍	تهان
ତାରା	تارا
ତିଇବ୍ଯେଶ୍	تیإبییش
ତିବ୍ଯାନ୍	تیبیان
ତିରୁଚନ୍ଡ୍ରା	تیروتشندرا
ତୀକ୍ଶିକ	تیكشیك
ତୀନିଶ୍	تینیش
ତୁମ୍କି	تومكہ
ତେଜସ୍	تیجس
ତେଜସ୍ବ୍ବିତ	تیجسببیت
ତେଜି	تیجی
ତେଜୋବିକସ୍	تیجوبیكس
ତେଜ୍	تیج
ତେଶିନୀ	تیشینی
ତୋମୋଗ୍ନା	توموجنا
ତ୍ରିଲୂକାମନ୍	تریلوكامن
ତ୍ରିଲୋକ୍	تریلوك
ତ୍ରିଶ୍	تریش
ତ୍ରେଶା	تریشا
ଦକ୍ଶକ୍	دكشك
ଦକ୍ଶେଶ୍	دكشیش
ଦଜ୍ଶି	دجشی
ଦଞଟା	دنطا
ଦଞ୍ଟା	دنطا
ଦଟ୍ଟଟ୍ରି	دطططری
ଦନନ୍ଜଯ୍	دننجی
ଦନଶ୍ରି	دنشری
ଦନିଏଲ୍	دنییل
ଦନିଶ୍ଟା	دنیشطا
ଦନିଶ୍ତା	دنیشتا
ଦନୁଶ୍	دنوش
ଦନୁଶ୍ରି	دنوشری
ଦନେଶି	دنیشی
ଦନ୍ବି	دنبی
ଦବିନ୍	دبین
ଦବୀନା	دبینا
ଦଯନିଟା	دینیطا
ଦଯମଯୀ	دیمیی
ଦଯରାମ୍	دیرام
ଦରହସି	درهسی
ଦର୍ମେନ୍ଦର୍	درمیندر
ଦର୍ରେନ୍	دررین
ଦସା	دسا
ଦାମିନି	دامینی
ଦୀକ୍ଶି	دیكشی
ଦୀନା	دینا
ଦୀପକ୍ରାଜ୍	دیبكراج
ଦୀପଶ୍ରି	دیبشری
ଦୀପେଶ୍	دیبیش
ଦୀପ୍ଟିକା	دیبطیكا
ଦୀପ୍ଟିମୋଯୀ	دیبطیمویی
ଦୀପ୍ମାଲା	دیبمالا
ଦୀପ୍ଯୋଗ୍	دیبیوج
ଦୀଶ୍ନା	دیشنا
ଦୀହେର୍	دیهیر
ଦେକ୍ଶିତ୍	دیكشیت
ଦେନିଶ୍	دینیش
ଦେବ ପ୍ରିଯା	دیب برییا
ଦେବର୍ପନା	دیبربنا
ଦେବାର୍ଟି	دیبارطی
ଦେବିକ୍	دیبیك
ଦେବିଡାସ୍	دیبیداس
ଦେବିଲାଲ୍	دیبیلال
ଦେବେନ୍	دیبین
ଦେବେନ୍ଡ୍ରନାତ୍	دیبیندرنات
ଦେବେନ୍ଡ୍ରଶିକା	دیبیندرشیكا
ଦେବେଶି	دیبیشی
ଦେବ୍ ନରେନ୍	دیب نرین
ଦେବ୍କି	دیبكہ
ଦେବ୍ଜନି	دیبجنی
ଦେବ୍ଯଶି	دیبیشی
ଦେଲୀନା	دیلینا
ଦେଶ୍ନୀ	دیشنی
ଦେହଯ୍	دیهی
ଦୈବି	دایبی
ଦୈବିକ୍	دایبیك
ନକ୍ଶା	نكشا
ନଖ୍ରାଜ୍	نكهراج
ନଗନାତ୍	نجنات
ନଗାନ୍ଜଲି	نجانجلی
ନଗ୍ଗର୍	نججر
ନଗ୍ଦର୍	نجدر
ନଙୈ	ننگاي
ନଚ୍ନି	نتشنی
ନଟ୍ରାଜ୍	نطراج
ନଡୀଶ୍	ندیش
ନନ୍ଡି	نندی
ନବନୀତା	نبنیتا
ନବରାଜ୍	نبراج
ନବରାନ୍ଜନି	نبرانجنی
ନବିନା	نبینا
ନବିନ୍ଡ୍	نبیند
ନବିଲ୍	نبیل
ନବୁଅଲ୍	نبوال
ନବେଶା	نبیشا
ନବ୍କର୍	نبكر
ନବ୍କିରନ୍	نبكیرن
ନବ୍କୁନ୍ଜ୍	نبكونج
ନବ୍ଯା ଦୁର୍ଗା	نبیا دورجا
ନଭଯନ୍	نبهین
ନଭା	نبها
ନଭିଜ୍	نبهیج
ନଭିତା	نبهیتا
ନମି	نمی
ନମିଟା	نمیطا
ନମିଟ୍	نمیط
ନମିତା	نمیتا
ନମିଶା	نمیشا
ନମ୍ଡେବ୍	نمدیب
ନରସିମ୍ହା	نرسیمها
ନରେନ୍ଡ୍ରନ୍	نریندرن
ନର୍ମଡ୍	نرمد
ନର୍ରେଶ୍	نرریش
ନଲିନାକ୍ଶ୍	نلیناكش
ନାଇଟିକ୍	ناإطیك
ନାଲନ୍	نالن
ନାଲବେନ୍ଭା	نالبینبها
ନିକ୍କି	نیككہ
ନିଦି	نیدی
ନିଲମ୍ବରି	نیلمبری
ନୀଇଲ୍	نیإل
ନୀଜା	نیجا
ନୀତୁ	نیتو
ନୀରାଜା	نیراجا
ନୀଲବତି	نیلبتی
ନୀଲବ୍ଜା	نیلبجا
ନୀଲମେଗନ୍	نیلمیجن
ନୀଲଯା	نیلیا
ନୀଲୁ	نیلو
ନୀଲ୍	نیل
ନୀଲ୍ମାଦବ୍	نیلمادب
ନୀହା	نیها
ନେଟ୍ରାବଟି	نیطرابطی
ନେଡୁମରନ୍	نیدومرن
ନେମି	نیمی
ନେର୍ଯା	نیریا
ନେଲ୍ବିନ୍	نیلبین
ନୈମିଶ୍	نایمیش
ପଝନନ୍ଡାବର୍	بجهنندابر
ପତଲା	بتلا
ପତୋଜ୍	بتوج
ପତ୍ରଲିକା	بترلیكا
ପଦାମବତି	بدامبتی
ପଦ୍ମଜା	بدمجا
ପଦ୍ମବସା	بدمبسا
ପଦ୍ମମଲଧର	بدمملدهر
ପଦ୍ମଯନି	بدمینی
ପଦ୍ମାଗ୍ରିହ	بدماجریه
ପଦ୍ମାମୁଖୀ	بدماموكهی
ପଦ୍ମୋଡ୍ଭବ	بدمودبهب
ପଦ୍ମ୍	بدم
ପନିଟା	بنیطا
ପନ୍କଜା	بنكجا
ପନ୍ଖୁଡି	بنكهودی
ପନ୍ଖୁରି	بنكهوری
ପନ୍ଚଜନା	بنتشجنا
ପନ୍ଚାବକ୍ଟ୍ରା	بنتشابكطرا
ପନ୍ଡୁ	بندو
ପନ୍ନାଲାଲ୍	بننالال
ପବନ୍ କୁମାର୍	ببن كومار
ପବିକରାନ୍	ببیكران
ପବେଶ୍	ببیش
ପବ୍ଲୀନ୍	ببلین
ପରବାସୁ	برباسو
ପରବି	بربی
ପରବ୍	برب
ପରମାର୍ତା	برمارتا
ପରମେସ୍ବୁଅରି	برمیسبواری
ପରିକା	بریكا
ପରିକେତ୍	بریكیت
ପରିଜଟ୍	بریجط
ପରିତୋଶ୍	بریتوش
ପରିସା	بریسا
ପର୍ଦୁ	بردو
ପର୍ନାଦ୍	برناد
ପର୍ନାଲ୍	برنال
ପର୍ନି	برنی
ପର୍ନିତା	برنیتا
ପର୍ବି	بربی
ପର୍ବୁଇନ୍ଡେର୍	بربوإندیر
ପର୍ମିତା	برمیتا
ପର୍ମେଶ୍ବୁଅର୍	برمیشبوار
ପର୍ଶ୍ବା	برشبا
ପଲକ୍	بلك
ପଲକ୍ଶି	بلكشی
ପଲାନି କୁମାର୍	بلانی كومار
ପଲ୍ବିଶ୍	بلبیش
ପାଚକ୍	باتشك
ପାବକି	بابكہ
ପାବନ୍	بابن
ପାର୍ତନ୍	بارتن
ପାର୍ତିଭ୍	بارتیبه
ପାର୍ବଟିନନ୍ଡନ୍	باربطینندن
ପିଯାଶା	بییاشا
ପିଯୁଶା	بییوشا
ପୀଟଶ୍ମା	بیطشما
ପୂଜିତା	بوجیتا
ପୂବିତନା	بوبیتنا
ପୂରିକା	بوریكا
ପେର୍ନିତା	بیرنیتا
ପୋଉଶାଲି	بووشالی
ପ୍ରଭା	بربها
ପ୍ରଭାବତ୍ଯ୍	بربهابتی
ପ୍ରାନ୍ବି	برانبی
ଫନିଶ୍ବୁଅର୍	بهنیشبوار
ଫଲାନି	بهلانی
ଫେରଲ୍	بهیرل
ବକ୍ରାଭୁଜ୍	بكرابهوج
ବକ୍ରୁତ୍	بكروت
ବଗ୍ମିନେ	بجمیني
ବଟୁକ୍	بطوك
ବତତ୍ମଜ୍	بتتمج
ବତ୍ସ୍ଯଯନ୍	بتسیین
ବନବରାଯନ୍	بنبراین
ବନାର୍	بنار
ବନିନି	بنینی
ବନିଲା	بنیلا
ବନିସ୍ରୀ	بنیسری
ବନ୍କା	بنكا
ବନ୍ଦୁ	بندو
ବନ୍ବିହାରି	بنبیهاری
ବନ୍ଭଟ୍ଟ୍	بنبهطط
ବନ୍ମାଲା	بنمالا
ବନ୍ମ୍ଜଲଜ୍	بنمجلج
ବନ୍ଶି	بنشی
ବନ୍ଶିଟା	بنشیطا
ବନ୍ଶିଲ୍	بنشیل
ବନ୍ସରି	بنسری
ବବଞା	ببنا
ବମାନିଏ	بمانیي
ବମ୍ସି	بمسی
ବମ୍ସୀ	بمسی
ବଯୁନ୍	بیون
ବରଦବିନଯକା	بردبینیكا
ବରଲକ୍ଶ୍ମି	برلكشمی
ବରୁନ୍	برون
ବରେନ୍ଡ୍ରା	بریندرا
ବର୍ଚେକା	برتشیكا
ବର୍ଦମାନ୍	بردمان
ବର୍ଦାନ୍	بردان
ବର୍ନିକା	برنیكا
ବର୍ଶନା	برشنا
ବର୍ଶନି	برشنی
ବର୍ଶିକା	برشیكا
ବଲାବନ୍	بلابن
ବଲେନ୍ଡୁ	بلیندو
ବଲ୍ମେକି	بلمیكہ
ବଲ୍ଲକି	بللكہ
ବଲ୍ଲି	بللی
ବସନ୍ଟାପ୍ରଭା	بسنطابربها
ବସନ୍ଟି	بسنطی
ବସନ୍ତ୍	بسنت
ବସବି	بسبی
ବସବ୍	بسب
ବସୁପତି	بسوبتی
ବସ୍ଟିନ୍	بسطین
ବାଗ୍ଡେବି	باجدیبی
ବାଚି	باتشی
ବାନି	بانی
ବାଲା ଗୋବିନ୍ଡ୍	بالا جوبیند
ବାଲ୍ ଗୋପଲ୍	بال جوبل
ବାସି	باسی
ବାସୁଦା	باسودا
ବାସୁଲକ୍ଶ୍ମି	باسولكشمی
ବିତିକା	بیتیكا
ବିଭା	بیبها
ବିଲ୍ବୁଆସ୍ରି	بیلبوآسری
ବିଶ୍ନୁ	بیشنو
ବୀଦାସ୍ରୀ	بیداسری
ବୀନାବନି	بینابنی
ବୀରସୁନ୍ଡରି	بیرسوندری
ବୁଆମନ୍	بوآمن
ବୁଆମିକା	بوآمیكا
ବୁବନା	بوبنا
ବେଡାନ୍	بیدان
ବେଡାନ୍ଶି	بیدانشی
ବେଡିତା	بیدیتا
ବେଦା	بیدا
ବେମ୍ବରାସି	بیمبراسی
ବେଲ୍	بیل
ବୈଜାଯନ୍ଟି	بایجاینطی
ବୈଡିଶ୍	بایدیش
ବୈଦିକ୍	بایدیك
ବୈନବି	باینبی
ବୈବଟ୍	بایبط
ବୈରବି	بایربی
ବୈଶାଲି	بایشالی
ବୈଶେକା	بایشیكا
ବୈଶ୍ନବି	بایشنبی
ବୈଶ୍ନୋଦେବି	بایشنودیبی
ବୈଶ୍ନୋବ୍	بایشنوب
ବ୍ରିଜା	بریجا
ବ୍ରିତ୍ହି	بریتهی
ବ୍ରିଶା	بریشا
ବ୍ରୁନ୍ଡା	بروندا
ଭନଦବ୍ଯା	بهندبیا
ଭଶ୍ବିକା	بهشبیكا
ଭସ୍କରା	بهسكرا
ଭାwନା	بهاwنا
ଭାଗ୍ବୁଅଟି	بهاجبواطی
ଭାଗ୍ବୁଅନ୍ଟି	بهاجبوانطی
ଭାଗ୍ଯ	بهاجی
ଭାଗ୍ଯନନ୍ଡନା	بهاجینندنا
ଭାଗ୍ଯଶ୍ରି	بهاجیشری
ଭାବଲନ୍	بهابلن
ଭାବିକ୍	بهابیك
ଭାରବି	بهاربی
ଭାସ୍କରି	بهاسكری
ଭାସ୍ବୁଅତ୍	بهاسبوات
ଭିଶ୍ମା	بهیشما
ଭୁମା	بهوما
ଭୌଟିକ୍	بهاوطیك
ଭୌମି	بهاومی
ଭ୍ରିତି	بهریتی
ଭ୍ରୁହନ୍ତ୍	بهروهنت
ମଗନ୍	مجن
ମଙଲମ୍	منگلم
ମଙଲା	منگلا
ମଙିରି	منگیری
ମଙୈ	منگاي
ମଡନ୍ମୋହନ୍	مدنموهن
ମଡୁର୍	مدور
ମଦୁ ବିନ୍ଡୁ	مدو بیندو
ମଦୁକ୍	مدوك
ମଦୁଚନ୍ଡା	مدوتشندا
ମଦୁନିକା	مدونیكا
ମଦୁମଯ୍	مدومی
ମଦୁମିତା	مدومیتا
ମଦୁରି	مدوری
ମନସ୍ବି	منسبی
ମନସ୍ବୁଇନି	منسبوإنی
ମନିଟ୍	منیط
ମନିତା	منیتا
ମନିନ୍ଡ୍ରା	منیندرا
ମନିମୋଝି	منیموجهی
ମନିରାମ୍	منیرام
ମନୀଟ୍	منیط
ମନୋଜ୍ନା	منوجنا
ମନ୍ଜିରି	منجیری
ମନ୍ଜୁଲ୍	منجول
ମନ୍ଡରା	مندرا
ମନ୍ଡର୍ମଲିକା	مندرملیكا
ମନ୍ଡାବି	مندابی
ମନ୍ତିକା	منتیكا
ମମତି	ممتی
ମମ୍ତା	ممتا
ମଲିନି	ملینی
ମଲ୍ଲି	مللی
ମଲ୍ଲୁ	مللو
ମଲ୍ଲେଶମ୍	مللیشم
ମଲ୍ଲେଶ୍	مللیش
ମହାକାଲ୍	مهاكال
ମହାକ୍ରମ୍	مهاكرم
ମହାଗୌରି	مهاجاوری
ମହାଜୀଟ୍	مهاجیط
ମହାଞା	مهانا
ମହାଟେଜସ୍	مهاطیجس
ମହାଡେବ୍	مهادیب
ମହାତି	مهاتی
ମହାନନ୍ଡ୍	مهانند
ମହାନ୍ଟ୍	مهانط
ମହାନ୍ତି	مهانتی
ମହାବାଲା	مهابالا
ମହାଭଡ୍ରା	مهابهدرا
ମହାମନି	مهامنی
ମହାରନ୍ତ୍	مهارنت
ମହାଲ୍ଯା	مهالیا
ମହାଶ୍ରି	مهاشری
ମହିରା	مهیرا
ମହିର୍	مهیر
ମହେନ୍ଡ୍ରା	مهیندرا
ମହେଶ୍ବୁଅର୍	مهیشبوار
ମହେସ୍ବୁଅରି	مهیسبواری
ମହ୍ନବ୍	مهنب
ମାକାଲି	ماكالی
ମାଞଟା	مانطا
ମାନବ୍	مانب
ମାନିକାନ୍ଟ୍	مانیكانط
ମାଲ୍ବିକା	مالبیكا
ମୈଟ୍ରଯୀ	مایطریی
ଯକ୍ଶିଟା	یكشیطا
ଯକ୍ଶିତ୍	یكشیت
ଯଗ୍ନକଯା	یجنكیا
ଯଟିଶ୍	یطیش
ଯତି	یتی
ଯତିଶ୍	یتیش
ଯଯିନ୍	ییین
ଯଶବୁଇନି	یشبوإنی
ଯଶାଶ୍ରୀ	یشاشری
ଯଶାସ୍ବି	یشاسبی
ଯଶି	یشی
ଯଶ୍ ରାଜ୍	یش راج
ଯଶ୍ବନ୍ତ୍	یشبنت
ଯଶ୍ରୀ	یشری
ଯସ୍ବୁଅନ୍ତ୍	یسبوانت
ଯାଗ୍ଯାସେନ୍	یاجیاسین
ଯାଜଟ୍	یاجط
ଯାଟୁଦନି	یاطودنی
ଯାଡାବେନ୍ଡ୍ରା	یادابیندرا
ଯାମାହିଲ୍	یاماهیل
ଯାମୁନା	یامونا
ଯାମ୍ଯା	یامیا
ଯାହ୍ବି	یاهبی
ଯୁକସ୍ରି	یوكسری
ଯୁଗନ୍ଶ୍	یوجنش
ଯୁଗେନ୍ଡେର୍	یوجیندیر
ଯୁବନ୍ ସୁର୍ଯା	یوبن سوریا
ଯୁବରାନି	یوبرانی
ଯୁବାରାମ୍	یوبارام
ଯୁବିନ୍	یوبین
ଯୁବ୍ରାନି	یوبرانی
ଯେଇଗବନ୍	ییإجبن
ଯେଘରାଜ୍	ییجهراج
ଯେତର୍ତ୍	ییترت
ଯେମା	ییما
ଯେସ୍ବୁଅନ୍ତ୍	ییسبوانت
ଯେସ୍ବୁଇନ୍	ییسبوإن
ଯୋଗାଜି	یوجاجی
ଯୋଗୀଟା	یوجیطا
ଯୋହନ୍	یوهن
ରକଶ୍ନ୍ଡା	ركشندا
ରକ୍ଶଟି	ركشطی
ରକ୍ଶିନା	ركشینا
ରଘୁନନ୍ଡନ୍	رجهونندن
ରଘୁନାତ୍	رجهونات
ରଙିତ୍	رنگیت
ରଜନିକାନ୍ଟା	رجنیكانطا
ରଜନ୍ଞା	رجننا
ରଟନା	رطنا
ରଟ୍ନା ପ୍ରିଯା	رطنا برییا
ରଟ୍ନାଜ୍ଯୋଟି	رطناجیوطی
ରଟ୍ନାବଲି	رطنابلی
ରତ୍ନା	رتنا
ରନିଶ୍	رنیش
ରନ୍ଜନି	رنجنی
ରନ୍ଜଯ୍	رنجی
ରନ୍ଜୁ	رنجو
ରନ୍ବିତା	رنبیتا
ରବିପ୍ରଭା	ربیبربها
ରବିଯାନ୍କି	ربییانكہ
ରବେକ୍	ربیك
ରମନୁଜମ୍	رمنوجم
ରମାକାନ୍ଟ୍	رماكانط
ରମାଦେବି	رمادیبی
ରମୈଅହ୍	رمایاه
ରମ୍ଯଦେବି	رمیدیبی
ରଶିକା	رشیكا
ରଶିଲା	رشیلا
ରଶ୍ବୁଇନା	رشبوإنا
ରଶ୍ମିନ୍	رشمین
ରସୁଲ୍	رسول
ରହାମ୍	رهام
ରହ୍ନି	رهنی
ରାଓସହେବ୍	رااوسهیب
ରାକା	راكا
ରାଗେଶ୍	راجیش
ରାଘବା	راجهبا
ରାଘବ୍	راجهب
ରାଜଲକ୍ଶ୍ମି	راجلكشمی
ରାଜାରମନ୍	راجارمن
ରାଜାରମେଶ୍	راجارمیش
ରାଜେଶ୍ରମ୍	راجیشرم
ରାଜ୍	راج
ରାଜ୍ କିରନ୍	راج كیرن
ରାଜ୍କଲା	راجكلا
ରାଝନ୍ସ୍	راجهنس
ରାଧା କ୍ରିଶ୍ନା	رادها كریشنا
ରାମୋଜି	راموجی
ରାମ୍	رام
ରାମ୍ଗୋପାଲ୍	رامجوبال
ରାମ୍ସାଗର୍	رامساجر
ରାହୁଲ୍ରାଜ୍	راهولراج
ରୀଟ୍	ریط
ରୀତନା	ریتنا
ରୀନା	رینا
ରୀମା	ریما
ରେବନ୍ତି	ریبنتی
ରେବନ୍ତିକା	ریبنتیكا
ରେମିତା	ریمیتا
ରେଶିତା	ریشیتا
ରେହେଇଲା	ریهیإلا
ରୈନା	راینا
ଲକ୍ଶନା	لكشنا
ଲକ୍ଶା	لكشا
ଲକ୍ଶିଟା	لكشیطا
ଲକ୍ଶ୍ମି	لكشمی
ଲକ୍ଶ୍ମି ପ୍ରିଯା	لكشمی برییا
ଲଜ୍ଜବୁଅଟି	لججبواطی
ଲଜ୍ବଟି	لجبطی
ଲଜ୍ବନ୍ଟି	لجبنطی
ଲତା	لتا
ଲନିବନ୍	لنیبن
ଲବନା	لبنا
ଲବିନ୍	لبین
ଲବ୍ଯ୍	لبی
ଲମ୍ବକର୍ନା	لمبكرنا
ଲରଞା	لرنا
ଲରିନା	لرینا
ଲଲମ୍	للم
ଲଲିଟ୍ମୋହନ୍	للیطموهن
ଲଲିଟ୍ରାଜ୍	للیطراج
ଲସିକ୍	لسیك
ଲହାରି	لهاری
ଲାଲିଟ୍ଯା	لالیطیا
ଲାଲିମା	لالیما
ଲାସ୍ଯା	لاسیا
ଲିଙେଶ୍	لینگیش
ଲିନିଶା	لینیشا
ଲିମିଶା	لیمیشا
ଲିଯାନା	لییانا
ଲିଲା	لیلا
ଲିଲାଦର୍	لیلادر
ଲିଶନ୍ତ୍	لیشنت
ଲୀଲବୁଅଟି	لیلبواطی
ଲୁନି	لونی
ଲୁମ୍ବିକା	لومبیكا
ଲୁମ୍ବିନି	لومبینی
ଲୁହିଟ୍	لوهیط
ଲୂକେଶ୍ବୁଅରି	لوكیشبواری
ଲେଖିଶା	لیكهیشا
ଲେଖ୍ଯା	لیكهیا
ଲେନିଶା	لینیشا
ଲେପକ୍ଶ୍	لیبكش
ଲେମା	لیما
ଲୋଉକ୍ଯା	لووكیا
ଲୋକକ୍ରିଟି	لوككریطی
ଲୋକିନି	لوكینی
ଲୋକେଶ୍ବୁଅରନ୍	لوكیشبوارن
ଲୋକ୍ପ୍ରକାଶ୍	لوكبركاش
ଲୋଗିଟା	لوجیطا
ଲୋବେଶ୍	لوبیش
ଲୋମଶ୍	لومش
ଲୋହିଟା	لوهیطا
ସକଲେଶ୍ବୁଅର୍	سكلیشبوار
ସଙିଟା	سنگیطا
ସଙିନି	سنگینی
ସଚନ୍ଡ୍ରା	ستشندرا
ସଚି	ستشی
ସଚିଡାନନ୍ଡ୍	ستشیدانند
ସଚିନ୍	ستشین
ସଚିନ୍ଡେଓ	ستشیندیاو
ସଚେଟନ୍	ستشیطن
ସଡାର୍	سدار
ସଡାଶିବା	سداشیبا
ସଡିଶ୍	سدیش
ସଡ୍ଗଟି	سدجطی
ସଡ୍ଗୁରୁ	سدجورو
ସଦନା	سدنا
ସନ୍କରି	سنكری
ସନ୍ଜନ	سنجن
ସନ୍ଜିଟା	سنجیطا
ସବରୀଶ୍	سبریش
ସବିତା	سبیتا
ସବୁରି	سبوری
ସବ୍ରଙ୍	سبرنگ
ସଭ୍ଯା	سبهیا
ସଭ୍ରନ୍ଟ୍	سبهرنط
ସମଞା	سمنا
ସମତା	سمتا
ସମିକା	سمیكا
ସମେନ୍	سمین
ସମେଶ୍	سمیش
ସମ୍ବିତି	سمبیتی
ସମ୍ବିତ୍	سمبیت
ସମ୍ବୁଡ୍ଦା	سمبوددا
ସମ୍ବୋଦ୍	سمبود
ସମ୍ଯତା	سمیتا
ସମ୍ରିଡ୍ଦା	سمریددا
ସଲେନା	سلینا
ସଲୋଖ୍	سلوكه
ସଲୋହି	سلوهی
ସହଡେବ୍	سهدیب
ସହ୍ଡେବ୍	سهدیب
ସାଇ ଆନନ୍ଡ୍	ساإ آنند
ସାଇ କୁମାରି	ساإ كوماری
ସାଇ କୁମାର୍	ساإ كومار
ସାଇ ବାନି	ساإ بانی
ସାଇ ସର୍ବେଶ୍	ساإ سربیش
ସାଇଯ୍ଯାନ୍	ساإییان
ସାଜିତ୍	ساجیت
ସାଜିଲି	ساجیلی
ସାଟ୍ବିକ୍	ساطبیك
ସାନିଦ୍ଯା	سانیدیا
ସାନିଯା	سانییا
ସାରାନ୍ଶ୍	سارانش
ସାହସ୍ଟ୍ରାଜିଟ୍	ساهسطراجیط
ସାହିଟ୍ଯା	ساهیطیا
ସାହିରାମ୍	ساهیرام
ସାହିଲ୍	ساهیل
ସାହୁଲ୍	ساهول
ସୈଜଯାନି	سایجیانی
ସୈଜାସି	سایجاسی
ସୈଜିଲ୍	سایجیل
ସୈନାତ୍	ساینات
ସୈନିଟ୍	ساینیط
ସୈହିଶ୍	سایهیش
ହନିମା	هنیما
ହନିଶା	هنیشا
ହନିଶ୍	هنیش
ହନୀଶା	هنیشا
ହନୁମନ୍ଟା	هنومنطا
ହବିହ୍	هبیه
ହମ୍ସାନନ୍ଡି	همسانندی
ହମ୍ସିକା	همسیكا
ହରିକିଶନ୍	هریكیشن
ହରିଟେଜା	هریطیجا
ହରିତା	هریتا
ହରିତ୍	هریت
ହରିଦ	هرید
ହରିନା	هرینا
ହରିନାରାଯନ୍	هریناراین
ହରିପେଅସାଡ୍	هریبیاساد
ହରିମନ୍ଟି	هریمنطی
ହରେଶ୍	هریش
ହର୍କେଶ୍	هركیش
ହର୍ଟେଇଜ୍	هرطیإج
ହର୍ବି	هربی
ହର୍ଶଲା	هرشلا
ହର୍ଶିତା	هرشیتا
ହର୍ଶିତ୍	هرشیت
ହର୍ଶ୍ ବୀର୍	هرش بیر
ହର୍ଶ୍ନିଲ୍	هرشنیل
ହର୍ସିକା	هرسیكا
ହଶ୍ମିତା	هشمیتا
ହଶ୍ରୀ	هشری
ହସିଟା	هسیطا
ହସିନା	هسینا
ହସ୍ତା	هستا
ହସ୍ବିତା	هسبیتا
ହସ୍ମିତା	هسمیتا
ହାରିତ୍	هاریت
ହିଟେନ୍ଡ୍ରା	هیطیندرا
ହିତେଶ୍	هیتیش
ହିମା	هیما
ହିମାଗୋଉରି	هیماجووری
ହିମାଘ୍ନା	هیماجهنا
ହିମାନ୍ସୁ	هیمانسو
ହିମାବନ୍ତ୍	هیمابنت
ହିରଞଦା	هیرندا
ହିରନ୍ମଯି	هیرنمیی
ହିରନ୍ମଯ୍	هیرنمی
ହିରିଶା	هیریشا
ହିର୍ବୁଅ	هیربوا
ହିଲ୍ଲା	هیللا
ହୀଟ୍ରାଜ୍	هیطراج
ହୀନା	هینا
ହୀର୍ବ	هیرب
ହେଇଡି	هیإدی
ହେଟବ୍	هیطب
ହେଟୁ	هیطو
ହେଟ୍ବୀକ୍	هیطبیك
ହେଟ୍ସ୍ଯା	هیطسیا
ହେତନ୍ଶି	هیتنشی
ହେନଲ୍	هینل
ହେମଙିନି	هیمنگینی
ହେମନ୍ଟ୍	هیمنط
ହେମନ୍ତ୍	هیمنت
ହେମନ୍ତ୍ସ୍ରୀ	هیمنتسری
ହେମପ୍ରସାଡ୍	هیمبرساد
ହେମବଟିନନ୍ଡନ୍	هیمبطینندن
ହେମସ୍ରି	هیمسری
ହେମିଶା	هیمیشا
ହେମ୍କେଶ୍	هیمكیش
ହେମ୍କ୍ରିଶ୍	هیمكریش
ହେମ୍ରାଜ୍	هیمراج
ହେରକ୍	هیرك
ହୋନ୍ହାର୍	هونهار
ହ୍ରିଦ୍ଯା	هریدیا
