# Baby names
અંશ	انش
અકન્ગ્ષા	اكنجشا
અકશીની	اكشینی
અકસરા	اكسرا
અકાર્યસુતા	اكاریسوتا
અકાલકા	اكالكا
અકિતા	اكیتا
અક્ષધા	اكشدها
અક્ષ્યા	اكشیا
અક્સા	اكسا
અગ્નિશિખા	اجنیشیكها
અગ્રીમા	اجریما
અચલેંદ્ર	اتشلیندر
અજન્તા	اجنتا
અજમુખી	اجموكهی
અજિયા	اجییا
અજીતા	اجیتا
અડ્યાદવૈતા	ادیادوایتا
અદવૈકા	ادوایكا
અદિતરાજ	ادیتراج
અદિત્યેશ	ادیتییش
અદીતીયા	ادیتییا
અદીરા	ادیرا
અદેન્ય	ادینی
અદ્રિતા	ادریتا
અદ્રિતી	ادریتی
અદ્વય	ادوی
અદ્વિકા	ادویكا
અદ્વેત	ادویت
અદ્વૈયા	ادواییا
અધીર	ادهیر
અધીરતા	ادهیرتا
અધ્યાત્મ	ادهیاتم
અબિનય	ابینی
અબિભવા	ابیبهوا
અબીનાવ	ابیناو
અબીશા	ابیشا
અબીસેશન	ابیسیشن
અબ્બીર	اببیر
અભિજાત	ابهیجات
અભિજ્ઞાન	ابهیجنان
અભિનું	ابهینون
અભિપ્રિથિ	ابهیبریتهی
અભિમોદા	ابهیمودا
અભિરુચિ	ابهیروتشی
અભિવાદન	ابهیوادن
અભિસુમત	ابهیسومت
અભિસોકા	ابهیسوكا
અભીકાંક્ષા	ابهیكانكشا
અભીચંદ્ર	ابهیتشندر
અભીજુન	ابهیجون
અભીધર્મ	ابهیدهرم
અભીલેશ	ابهیلیش
અભુ	ابهو
અભ્થા	ابهتها
અભ્રકાસિન	ابهركاسین
અરધ્યાય	اردهیای
અલંકારાપ્રિયા	النكارابرییا
અલંક્રિતા	النكریتا
અહીના	اهینا
આંદાલ	آندال
આંશી	آنشی
આએઇન્દ્રિ	آیإندری
આકર્ષ	آكرش
આકાંક્ષ	آكانكش
આકામ્પન	آكامبن
આકાશ	آكاش
આકાશી	آكاشی
આકેશ	آكیش
આત્મજ	آتمج
આત્રયી	آتریی
આદાવન	آداون
આદિકવિ	آدیكوی
આદિકેશ	آدیكیش
આદિતિય	آدیتیی
આદિત્વ	آدیتو
આદિદેવ	آدیدیو
આદિશ	آدیش
આદિશંકર	آدیشنكر
આદિસેશ	آدیسیش
આદીત્રી	آدیتری
આદીલ	آدیل
આદ્યા	آدیا
આનંદતા	آنندتا
આનાધીતા	آنادهیتا
આનુષ	آنوش
આમાંની	آماننی
આયાતી	آیاتی
આયુધ	آیوده
આરવી	آروی
આરા	آرا
આરાડ્યા	آرادیا
આરાધક	آرادهك
આરાધના	آرادهنا
આરુન્ય	آرونی
આરુપા	آروبا
આરોચન	آروتشن
આર્થ	آرته
આર્ય્થ્ય	آریتهی
આલય	آلی
આલિશા	آلیشا
આલેઃયા	آلیهایا
આલ્યા	آلیا
આવાની	آوانی
આવ્યા	آویا
આશાલી	آشالی
આશીર્વાદ	آشیرواد
આસ્યા	آسیا
આસ્વી	آسوی
આહ્નીક	آهنیك
ઇંદિરા	إندیرا
ઇંદિવર	إندیور
ઇંદુલેક્ષ	إندولیكش
ઇંદુશેખર	إندوشیكهر
ઇતિ	إتی
ઇતિશ્રી	إتیشری
ઇદિત્રી	إدیتری
ઇનકી	إنكی
ઇન્કિત	إنكیت
ઇન્ગનામ	إنجنام
ઇન્દ્રતેજ	إندرتیج
ઇન્દ્રન	إندرن
ઇન્દ્રેશ	إندریش
ઇભાન	إبهان
ઇભ્યા	إبهیا
ઇયેનગર	إیینجر
ઇલવરસન	إلورسن
ઇલિસા	إلیسا
ઇવાન	إوان
ઇશા	إشا
ઇશાયુ	إشایو
ઇસાર	إسار
ઇસીરી	إسیری
ઈઝ્રીને	إجهریني
ઈનિઅવેલન	إنیاویلن
ઈનિયવન	إنییون
ઈન્દુસ	إندوس
ઈરીશ	إریش
ઈલ્વિકા	إلویكا
ઈશાંત	إشانت
ઈશિત	إشیت
ઈશ્મીતા	إشمیتا
ઈશ્વ	إشو
ઈસાઈ	إساإ
ઉજય	وجی
ઉજાગર	وجاجر
ઉજાસ	وجاس
ઉજીત્ર	وجیتر
ઉજેન્દ્ર	وجیندر
ઉજ્જાનિની	وججانینی
ઉજ્જ્વાલા	وججوالا
ઉત્કર્શ્રાજ	وتكرشراج
ઉત્કલ	وتكل
ઉત્કલીતા	وتكلیتا
ઉત્કશાના	وتكشانا
ઉત્પત્તિ	وتبتتی
ઉત્પલ	وتبل
ઉત્વિક	وتویك
ઉત્સા	وتسا
ઉથીશા	وتهیشا
ઉદંત	ودنت
ઉદયાચલ	ودیاتشل
ઉદરથી	ودرتهی
ઉદાર્શ	ودارش
ઉદેય	ودیی
ઉદ્વંશ	ودونش
ઉધાયારની	ودهایارنی
ઉપજય	وبجی
ઉપદા	وبدا
ઉપનાયિક	وبناییك
ઉપાગુપ્તા	وباجوبتا
ઉપેન્દ્રન	وبیندرن
ઉભય	وبهی
ઉમાંપુત્ર	ومانبوتر
ઉમાપત્ય	ومابتی
ઉમિકા	ومیكا
ઉમેશ	ومیش
ઉરિશિલ્લા	وریشیللا
ઉર્નીક	ورنیك
ઉર્મિલ	ورمیل
ઉર્મિલા	ورمیلا
ઉર્મી	ورمی
ઉર્વીશા	ورویشا
ઉલ્લાસીથા	وللاسیتها
ઉસહાસ	وسهاس
ઉસ્લુંનન	وسلوننن
ઊર્જિત	ورجیت
એઇલા	یإلا
એકદંતન	یكدنتن
એકન્ષા	یكنشا
એકાંશ	یكانش
એકાચક્ર	یكاتشكر
એકાવિરા	یكاویرا
એકીશ	یكیش
એકેસ્વારા	یكیسوارا
એક્શીકા	یكشیكا
એદોમ	یدوم
એપ્શીતા	یبشیتا
એલાવારાસન	یلاواراسن
એલેના	یلینا
એવાની	یوانی
એવોન	یوون
એશંકા	یشنكا
એશાન્ય	یشانی
ઐસીરી	ایسیری
ઓજ્જસ્વીન	اوججسوین
ઓદથી	اودتهی
ઓનિશ	اونیش
ઓનીર	اونیر
ઓન્નેશા	اوننیشا
ઓબલેશ	اوبلیش
ઓમપતિ	اومبتی
ઓમવતી	اوموتی
ઓમિષા	اومیشا
ઓવીએ	اوویي
ઓહા	اوها
કંકના	كنكنا
કંજમ	كنجم
કંઠ	كنطه
કંવર	كنور
કતીરેશન	كتیریشن
કથીર	كتهیر
કદિતુલા	كدیتولا
કનક	كنك
કનીસા	كنیسا
કનુષ	كنوش
કપિલા	كبیلا
કમલનયન	كملنین
કમલાબંધુ	كملابندهو
કરબી	كربی
કરીના	كرینا
કરીશા	كریشا
કરીસમાં	كریسمان
કરુન્યા	كرونیا
કર્ણ	كرن
કર્તીગા	كرتیجا
કર્નાપ્રિયા	كرنابرییا
કર્નીકા	كرنیكا
કર્નીશ	كرنیش
કલમજીરરન્જિનિ	كلمجیررنجینی
કલાતર	كلاتر
કલાપક	كلابك
કલાપ્રિયા	كلابرییا
કલૈસેલવી	كلایسیلوی
કલ્પ	كلب
કલ્પેશ	كلبیش
કવચ	كوتش
કવિનયા	كوینیا
કવીપ્રનીતા	كویبرنیتا
કશિશ	كشیش
કશ્યપ	كشیب
કસ્તૂરી	كستوری
કહન	كهن
કાંવ	كانو
કાજળ	كاجر
કાત્યયાની	كاتییانی
કાદમ્બિની	كادمبینی
કાનાસુ	كاناسو
કાન્જીરા	كانجیرا
કામાખ્યા	كاماكهیا
કામિકા	كامیكا
કામીક	كامیك
કામેરીના	كامیرینا
કાયંશ	كاینش
કાયલવિલી	كایلویلی
કારૂકા	كاروكا
કાલપી	كالبی
કાલિંદી	كالیندی
કાલિરંજન	كالیرنجن
કાવ્યંશ	كاوینش
કાષ્ઠ	كاشطه
કિન્નેરા	كیننیرا
કિર્તિત	كیرتیت
કિશા	كیشا
કેતવ	كیتو
કેતિકા	كیتیكا
કેતીત	كیتیت
કેદારનાથ	كیدارناته
કેનિષા	كینیشا
કેયા	كییا
કેયાન	كییان
કેલ્વીન	كیلوین
કેવલકુમાર	كیولكومار
કેવિકા	كیویكا
કેવ્લીના	كیولینا
કેશિકા	كیشیكا
કેશિન	كیشین
કેશોરી	كیشوری
કેસવા	كیسوا
કૈરવી	كایروی
કૈલાશચંદ્ર	كایلاشتشندر
કૌશિક	كاوشیك
કૌશેય	كاوشیی
કૌસ્તુભી	كاوستوبهی
ખરાધ્વામ્સીને	كهرادهوامسیني
ખાદીર	كهادیر
ખાવ્યા	كهاویا
ખુશ્બૂ	كهوشبو
ખેજલ	كهیجل
ગંગા	جنجا
ગંગિકા	جنجیكا
ગંગી	جنجی
ગંગેયા	جنجییا
ગંગેશ	جنجیش
ગંદિરા	جندیرا
ગંધા	جندها
ગંધાર	جندهار
ગજપતિ	ججبتی
ગ઼ુનસૂંદરી	جونسوندری
ગાંધામધના	جاندهامدهنا
ગાયન	جاین
ગાલવ	جالو
ગીતિકા	جیتیكا
ગીતીશા	جیتیشا
ગીતેશ	جیتیش
ગીત્શ	جیتش
ગીરિષા	جیریشا
ગીર્જેશ	جیرجیش
ગીવીથા	جیویتها
ગીહિતી	جیهیتی
ગુણવાથી	جونواتهی
ગુદાકેશ	جوداكیش
ગુનાક્ષી	جوناكشی
ગુનાનીધી	جونانیدهی
ગુનિના	جونینا
ગુનીત	جونیت
ગુરનામ	جورنام
ગુરીશ	جوریش
ગુરુશરણ	جوروشرن
ગોપાલ કૃષ્ણન	جوبال كرشنن
ગોવરી	جووری
ગોવ્થમી	جووتهمی
ગૌરિકાંત	جاوریكانت
ગૌરેશ	جاوریش
ગૌર્યનવી	جاورینوی
ગ્યાનવી	جیانوی
ગ્રહિત	جرهیت
ઘટા	جهطا
ઘનાનંદ	جهنانند
ઘુંગરૂ	جهونجرو
ચંચલાદવાલા	تشنتشلادوالا
ચંચારી	تشنتشاری
ચંચારીક	تشنتشاریك
ચંદિકા	تشندیكا
ચંદ્ર ભાન	تشندر بهان
ચંદ્રકિરણ	تشندركیرن
ચંદ્રકીર્તી	تشندركیرتی
ચંદ્રબિંદુ	تشندربیندو
ચક્રદેવ	تشكردیو
ચક્રિક	تشكریك
ચન્દ્રવદન	تشندرودن
ચન્દ્રહાસ	تشندرهاس
ચમેલી	تشمیلی
ચરક	تشرك
ચરણજીત	تشرنجیت
ચરણરજ	تشرنرج
ચરિત	تشریت
ચરુલા	تشرولا
ચસ્મીતા	تشسمیتا
ચાકરીન	تشاكرین
ચાને	تشاني
ચાન્નક્કા	تشاننككا
ચાન્નાય	تشاننای
ચારીકા	تشاریكا
ચારુદત્ત	تشارودتت
ચારુલતા	تشارولتا
ચારુશીલા	تشاروشیلا
ચિંટૂ	تشینطو
ચિતહેશ	تشیتهیش
ચિત્કલા	تشیتكلا
ચિત્તસ્વરૂપ	تشیتتسوروب
ચિત્રકુન્દાલા	تشیتركوندالا
ચિત્રલ	تشیترل
ચિત્રેશ	تشیتریش
ચિદાત્મા	تشیداتما
ચિધાત્મા	تشیدهاتما
ચિન્મય	تشینمی
ચિર્ત્રંગ	تشیرترنج
ચીન્નીઃ	تشیننیها
ચેથના	تشیتهنا
ચેનના	تشیننا
ચૈતન	تشایتن
ચૈત્રી	تشایتری
ચોલામિત્ર	تشولامیتر
ચૌનતા	تشاونتا
છાયા	تشهایا
જગતપાલ	ججتبال
જગદગુરુવે	ججدجورووي
જગદીપ	ججدیب
જગન	ججن
જગિશ	ججیش
જગ્ગેર	جججیر
જગ્સના	ججسنا
જનતા	جنتا
જનાદેવ	جنادیو
જનાર્દનન	جناردنن
જનિતા	جنیتا
જન્મ	جنم
જમ્બાવતી	جمباوتی
જય ગોપાલ	جی جوبال
જયંતાસેના	جینتاسینا
જયદા	جیدا
જયન	جین
જયમેન	جیمین
જયલક્ષ્મી	جیلكشمی
જયલલીથા	جیللیتها
જયશેખર	جیشیكهر
જયહરી	جیهری
જયાકીર્તન	جیاكیرتن
જયાપાદમાં	جیابادمان
જયાલક્ષ્મી	جیالكشمی
જય્મીની	جیمینی
જલાગંધા	جلاجندها
જલાર્ક	جلارك
જલ્પેશ	جلبیش
જશપાલ	جشبال
જસ્લીના	جسلینا
જસ્વીથા	جسویتها
જસ્સીચા	جسسیتشا
જહાંગીર	جهانجیر
જાગ્રત	جاجرت
જાગ્રવ	جاجرو
જાઝીમ	جاجهیم
જાતાવેદાસ	جاتاویداس
જાનકીરમન	جانكیرمن
જાનવી	جانوی
જાનહાન	جانهان
જાન્વી	جانوی
જામીની	جامینی
જાલેંદ્ર	جالیندر
જાહનવી	جاهنوی
જિનાભદ્ર	جینابهدر
જિલેશ	جیلیش
જિલ્પા	جیلبا
જીગર	جیجر
જીતીશ	جیتیش
જીન	جین
જીન્શીત	جینشیت
જીમૂત	جیموت
જીલવ	جیلو
જીવા	جیوا
જીવિકા	جیویكا
જીવેશ	جیویش
જીશના	جیشنا
જીશું	جیشون
જુનીતા	جونیتا
જેગપ્રીયાન	جیجبرییان
જેતલ	جیتل
જેનીતા	جینیتا
જેબીશા	جیبیشا
જૈચંદ	جایتشند
જૈચરણ	جایتشرن
જૈદેવ	جایدیو
જૈસંકર	جایسنكر
જૈસ્યા	جایسیا
જોયાત્રી	جویاتری
જોવાકી	جوواكی
જોવિતા	جوویتا
જોસ્યા	جوسیا
જ્ઞાન	جنان
જ્ઞાનાલ	جنانال
જ્યોસ્તના	جیوستنا
ઝંકાર	جهنكار
ઝરલ	جهرل
ઝાએઈ	جهایإ
ઝારા	جهارا
ઝિનૂક	جهینوك
ઝુબીન	جهوبین
ઝુલિએર	جهولییر
ઝેનીલ	جهینیل
ઠરાનીકા	طهرانیكا
ડાલી	دالی
તંગમ	تنجم
તક્ષક	تكشك
તથાથાન	تتهاتهان
તનવી	تنوی
તનવીર	تنویر
તનિશ્ક	تنیشك
તનુપા	تنوبا
તન્નિષ્ઠા	تننیشطها
તન્વી શ્રી	تنوی شری
તપસેન્દ્ર	تبسیندر
તપસ્વિની	تبسوینی
તમન	تمن
તમન્ના	تمننا
તમોનષ	تمونش
તયા	تیا
તરણ	ترن
તરનીજા	ترنیجا
તરુણી	ترونی
તરુશ્રી	تروشری
તરોશ	تروش
તશા	تشا
તસ્મિ	تسمی
તસ્ય	تسی
તાનક	تانك
તાના	تانا
તાની	تانی
તાનીશતા	تانیشتا
તાન્વી	تانوی
તાન્વેશા	تانویشا
તામસી	تامسی
તામીલ્મરણ	تامیلمرن
તારક	تارك
તારકેશ	تاركیش
તારકેશ્વર	تاركیشور
તારાનીસેન	تارانیسین
તારોક	تاروك
તાલંક	تالنك
તાલીન	تالین
તાવીનીશ	تاوینیش
તિક્શીકા	تیكشیكا
તિજિલ	تیجیل
તિતિર	تیتیر
તિનકા	تینكا
તિર્થાયાદ	تیرتهایاد
તિલકા	تیلكا
તિલોત્તમા	تیلوتتما
તીમિત	تیمیت
તીમીતા	تیمیتا
તીયાસા	تییاسا
તીરુગ્નાનમ	تیروجنانم
તીરુમેની	تیرومینی
તીર્થરાજ	تیرتهراج
તીશા	تیشا
તુકારામ	توكارام
તુન્ગાર	تونجار
તુલસા	تولسا
તૃષા	ترشا
તેજસી	تیجسی
તેજસ્વીતા	تیجسویتا
તેજસ્વીની	تیجسوینی
તેજેસ્વીની	تیجیسوینی
તેજોભાદ્ર	تیجوبهادر
તેર્ષમ	تیرشم
તેહીહ્યા	تیهیهیا
તોમોગના	توموجنا
તોશાની	توشانی
તોશીન	توشین
તૌરુસ	تاوروس
ત્રિકાયા	تریكایا
ત્રિધાત્રી	تریدهاتری
ત્રિનાથ	تریناته
ત્રિભુવન	تریبهوون
ત્રિમૂર્તિ	تریمورتی
ત્રિયા	ترییا
ત્રિવેન્દ્ર	تریویندر
ત્રિશુલાંક	تریشولانك
ત્રિષર	تریشر
ત્રીનેશ	ترینیش
ત્રીભુવન	تریبهوون
ત્રીલોકાત્માને	تریلوكاتماني
ત્રીવીક્રમાં	تریویكرمان
ત્રીવીદ	تریوید
ત્રેયા	ترییا
થનીરિકા	تهنیریكا
થાનીકા	تهانیكا
થાનીષા	تهانیشا
થાનીસરી	تهانیسری
થાન્યસ્રી	تهانیسری
થામીલારાસન	تهامیلاراسن
થારન્યા	تهارنیا
થેન્મોલી	تهینمولی
થ્રાયા	تهرایا
દક્શીકા	دكشیكا
દક્ષિત	دكشیت
દક્ષેષ	دكشیش
દજ્શી	دجشی
દધીચિ	ددهیتشی
દયસરા	دیسرا
દયાકર	دیاكر
દયાનીશ્કા	دیانیشكا
દરસાથ	درساته
દરહાસ	درهاس
દરિદ્રીયાનાશીની	دریدرییاناشینی
દર્શિકા	درشیكا
દર્સીકા	درسیكا
દલજીત	دلجیت
દલ્શેર	دلشیر
દશાગ્રીવા શીરોહરા	دشاجریوا شیروهرا
દસરાજા	دسراجا
દસ્માયા	دسمایا
દહા	دها
દહાના	دهانا
દાનુષ	دانوش
દારિકા	داریكا
દિક્ષી	دیكشی
દિપક્ષી	دیبكشی
દિપમ્શું	دیبمشون
દિપાશ્રી	دیباشری
દિપ્તા	دیبتا
દિશના	دیشنا
દીક્ષિકા	دیكشیكا
દીપનકર	دیبنكر
દીપમાળા	دیبمارا
દીપાના	دیبانا
દીપ્તિ	دیبتی
દેબન્શી	دیبنشی
દેબસ્મિતા	دیبسمیتا
દેબાસીસ	دیباسیس
દેબોરહ	دیبوره
દેબ્પ્રસાદ	دیببرساد
દેવ કુમાર	دیو كومار
દેવકલી	دیوكلی
દેવકી	دیوكی
દેવતા	دیوتا
દેવમતિ	دیومتی
દેવર્સી	دیورسی
દેવાંગી	دیوانجی
દેવાંશ	دیوانش
દેવાજુતા	دیواجوتا
દેવાદાર્શીની	دیوادارشینی
દેવાદીત્યા	دیوادیتیا
દેવાદ્યુમના	دیوادیومنا
દેવાનંદન	دیوانندن
દેવાપી	دیوابی
દેવાલીના	دیوالینا
દેવિદાસ	دیویداس
દેવિના	دیوینا
દેવીકી	دیویكی
દેવેન્દ્રનાથ	دیویندرناته
દેવેન્દ્રશીકા	دیویندرشیكا
દેવેશી	دیویشی
દેવ્યમ	دیویم
દેવ્યાની	دیویانی
દેવ્વાન્તી	دیووانتی
દેશવા	دیشوا
દેશીકા	دیشیكا
દેસના	دیسنا
દેસીકા	دیسیكا
દેહ્ય	دیهی
દૈત્ય	دایتی
દૈના	داینا
દૈપાયન	دایباین
દૈવી	دایوی
ધક્શીતા	دهكشیتا
ધક્ષતા	دهكشتا
ધન લક્ષ્મી	دهن لكشمی
ધનધાન્યકી	دهندهانیكی
ધનશિકા	دهنشیكا
ધનિયા	دهنییا
ધનુંર્ધારા	دهنونردهارا
ધમેન્દ્ર	دهمیندر
ધરમવીર	دهرمویر
ધરાસુતા	دهراسوتا
ધર્મઅધ્યક્ષ	دهرمادهیكش
ધર્મકીર્તિ	دهرمكیرتی
ધર્મીશ્તા	دهرمیشتا
ધવલ્યા	دهولیا
ધાર્શીકા	دهارشیكا
ધાવીશી	دهاویشی
ધિરા	دهیرا
ધીપ્ત્હા	دهیبتها
ધીમાહી	دهیماهی
ધૂન	دهون
ધૈર્ય	دهایری
ધ્રીશીકા	دهریشیكا
નંદ	نند
નંદકુમાર	نندكومار
નંદગોપાલ	نندجوبال
નક્શ	نكش
નક્ષાત્ર	نكشاتر
નગરજન	نجرجن
નબ્હિજ	نبهیج
નમસ્યૂ	نمسیو
નમીતા	نمیتا
નયાજ	نیاج
નયાસના	نیاسنا
નરીતા	نریتا
નર્મદા	نرمدا
નવતેજ	نوتیج
નવિન	نوین
નાકીસકા	ناكیسكا
નાકુશ	ناكوش
નાગનાથ	ناجناته
નાગાંજલી	ناجانجلی
નાગાનંદિની	ناجانندینی
નાગાર્જુન	ناجارجون
નાગેસ્વારી	ناجیسواری
નાટકપ્રિય	ناطكبریی
નાથ	ناته
નાન્દુની	ناندونی
નાભિ	نابهی
નાયક	نایك
નાયકી	نایكی
નારંગ	نارنج
નારન	نارن
નારાયન	ناراین
નાર્સપ્પા	نارسببا
નાવાન્ય	ناوانی
નાવાપ્રિયન	ناوابریین
નાશાલ	ناشال
નિકેતા	نیكیتا
નિખાલ	نیكهال
નિખિલ	نیكهیل
નિધન	نیدهن
નિપા	نیبا
નિબંધના	نیبندهنا
નિમેશ	نیمیش
નિરામઈ	نیرامإ
નિરામયા	نیرامیا
નિરૂપા	نیروبا
નિલિની	نیلینی
નિલ્લ	نیلل
નિશય	نیشی
નિશા	نیشا
નિશિ	نیشی
નિશિકા	نیشیكا
નિષ્ણાં	نیشنان
નિહિત	نیهیت
નીકુંજા	نیكونجا
નીકેશ્ય	نیكیشی
નીખેલ	نیكهیل
નીગી	نیجی
નીડી	نیدی
નીદિશ	نیدیش
નીધા	نیدها
નીપા	نیبا
નીપુના	نیبونا
નીબેદીતા	نیبیدیتا
નીરજ નયન	نیرج نین
નીરુધી	نیرودهی
નીરૈમાંથી	نیرایمانتهی
નીર્મુકતા	نیرموكتا
નીલંજન	نیلنجن
નીલાક્ષી	نیلاكشی
નીલ્પ્રબ્ભા	نیلبرببها
નીશીરા	نیشیرا
નીશોકા	نیشوكا
નીસ્ચીતા	نیستشیتا
નીસ્ચીથા	نیستشیتها
નેકા	نیكا
નેત્રતાવ	نیترتاو
નેમીચંદ	نیمیتشند
નેવી	نیوی
નેશ્વારી	نیشواری
નૈનીશા	ناینیشا
નૈમિષા	نایمیشا
નૈરુથી	نایروتهی
નૈલીકા	نایلیكا
નૌરિન	ناورین
પંકજલોચના	بنكجلوتشنا
પંકિત	بنكیت
પંચમી	بنتشمی
પંડી	بندی
પંથ	بنته
પક્ષી	بكشی
પક્ષીન	بكشین
પઝ્હેની	بجههینی
પણ-ગેશ	بن-جیش
પત્ર	بتر
પત્રલિકા	بترلیكا
પત્રીક	بتریك
પદમાંક્ષ્ય	بدمانكشی
પદમાવતી	بدماوتی
પદ્મ	بدم
પદ્માકર	بدماكر
પનિતા	بنیتا
પન્યશ્રી	بنیشری
પયોશ્નીકા	بیوشنیكا
પરમ	برم
પરમિલા	برمیلا
પરવાસૂ	برواسو
પરસમે	برسمي
પરસ્માઈ	برسماإ
પરાકાષ	براكاش
પરાક્રમ	براكرم
પરિચય	بریتشی
પરિષ	بریش
પરીસા	بریسا
પર્જન્ય	برجنی
પર્નલ	برنل
પર્વત	بروت
પલાશરંજન	بلاشرنجن
પલોમી	بلومی
પલ્લબ	بللب
પલ્લવિની	بللوینی
પલ્લવી	بللوی
પવીશ્ના	بویشنا
પહેલ	بهیل
પાઓલા	بااولا
પાગલાવન	باجلاون
પાન્દિયન	باندیین
પારબ્રહ્મ	باربرهم
પારવાથી	بارواتهی
પારાવ	باراو
પાર્થવ	بارتهو
પાર્થિવ	بارتهیو
પાર્થીવેન્દ્ર	بارتهیویندر
પાર્વતી નંદન	باروتی نندن
પાર્વાથી	بارواتهی
પાવકી	باوكی
પાવના	باونا
પાવાકી	باواكی
પિંગલા	بینجلا
પીઅલ્લી	بیاللی
પીતામ્બરા	بیتامبرا
પીનલ	بینل
પીયાશા	بییاشا
પીર્નાવ	بیرناو
પૂજન	بوجن
પૂર્ણલલીતા	بورنللیتا
પૂર્નાચંદ્રા	بورناتشندرا
પૂર્નામદા	بورنامدا
પૂર્વ	بورو
પૂર્વિકા	بورویكا
પૂર્વીજ્હા	بورویجها
પોંનન	بوننن
પોઉર્નીમાં	بوورنیمان
પોન્થારા	بونتهارا
પોરોમાં	بورومان
પોષ	بوش
પૌરવી	باوروی
પ્રંવુતા	برنووتا
પ્રગતીશા	برجتیشا
પ્રગ્યા	برجیا
પ્રણાલી	برنالی
પ્રનાદા	برنادا
પ્રન્જા	برنجا
પ્રભાકર	بربهاكر
પ્રભાતી	بربهاتی
પ્રભારૂપા	بربهاروبا
પ્રભાવતી	بربهاوتی
પ્રભ્રીતી	بربهریتی
પ્રહાર્શીની	برهارشینی
પ્રહાસા	برهاسا
પ્રાખ્યા	براكهیا
પ્રાણવાપ્રિયા	برانوابرییا
પ્રાનાદ	براناد
ફણીશ	بهنیش
ફલોની	بهلونی
ફુલ્લન	بهوللن
ફેની	بهینی
ફ્લાવીના	بهلاوینا
બત્નાસીદ્ધીકારા	بتناسیددهیكارا
બદરી	بدری
બન્દીન	بندین
બર્હન	برهن
બલામુરુગન	بلاموروجن
બલામ્બુ	بلامبو
બલ્લભ	بللبه
બવિયન	بویین
બસંતી	بسنتی
બસૂધા	بسودها
બાટલી	باطلی
બાલાજી	بالاجی
બાલારામ	بالارام
બાલેન્દ્ર	بالیندر
બાહુબલી	باهوبلی
બાહુલ્ય	باهولی
બિંકા	بینكا
બિજય	بیجی
બિધાન	بیدهان
બિનોય	بینوی
બિભવાસુ	بیبهواسو
બિમલા	بیملا
બિમ્બ	بیمب
બિસાલા	بیسالا
બીકાશ	بیكاش
બીન્દુસાગર	بیندوساجر
બીબોસ્વાન	بیبوسوان
બીભાકર	بیبهاكر
બીલ્વાની	بیلوانی
બીલ્વાનીલાયા	بیلوانیلایا
બુધીપ્રિયા	بودهیبرییا
બૂમિકા	بومیكا
બૃંદા	برندا
બેનીતા	بینیتا
બૈજયંતી	بایجینتی
બૈસાખી	بایساكهی
બૌમાંથી	باومانتهی
બ્રનુચિકા	برنوتشیكا
બ્રહ્માવતી	برهماوتی
બ્રિજબાલા	بریجبالا
ભગત	بهجت
ભગવંત	بهجونت
ભદ્રંગ	بهدرنج
ભદ્રક	بهدرك
ભદ્રકપિલ	بهدركبیل
ભરાન	بهران
ભર્તેશ	بهرتیش
ભવન	بهون
ભવરોગસ્યાભેશાજા	بهوروجسیابهیشاجا
ભવાની સંકર	بهوانی سنكر
ભાગીરત	بهاجیرت
ભાગ્યશબરી	بهاجیشبری
ભાગ્યા	بهاجیا
ભાગ્યેશ	بهاجییش
ભાનુજ	بهانوج
ભાનુપ્રિયા	بهانوبرییا
ભાનુમિત્ર	بهانومیتر
ભારતી	بهارتی
ભારવી	بهاروی
ભારુ	بهارو
ભાર્ગવા	بهارجوا
ભાવાનીલ	بهاوانیل
ભાવાપ્રિયા	بهاوابرییا
ભાવામોચની	بهاواموتشنی
ભાવાર્થ	بهاوارته
ભાવાલન	بهاوالن
ભાવિક	بهاویك
ભાવિન	بهاوین
ભાવેશ	بهاویش
ભાસુ	بهاسو
ભિમાંવેગ	بهیمانویج
ભીખી	بهیكهی
ભીમસેન	بهیمسین
ભીમાંન્શી	بهیماننشی
ભીલાનગના	بهیلانجنا
ભુવૈનીકા	بهوواینیكا
ભૂતપાલા	بهوتبالا
ભૂપેન્દ્ર	بهوبیندر
ભૂમીશ	بهومیش
ભૃગુ	بهرجو
ભેવીન	بهیوین
ભેસાજ	بهیساج
ભોજા	بهوجا
ભોલાનાથ	بهولاناته
મંગલા	منجلا
મંજુ પ્રસાદ	منجو برساد
મંજુનાથ	منجوناته
મંજુબાલા	منجوبالا
મંજૂશા	منجوشا
મંત	منت
મંત્રના	منترنا
મંથિકા	منتهیكا
મકર	مكر
મણિરત્ના	منیرتنا
મત્સ્યેંદ્ર	متسییندر
મદીન	مدین
મદુર	مدور
મધુ સ્મિતા	مدهو سمیتا
મધુકાંત	مدهوكانت
મધુદીપ	مدهودیب
મધુમાંલી	مدهومانلی
મધુમાલતી	مدهومالتی
મધુલા	مدهولا
મધુલેખા	مدهولیكها
મનનશ	مننش
મનવિર	منویر
મનસ્વિન	منسوین
મનસ્વિની	منسوینی
મનિભૂષણ	منیبهوشن
મનીતા	منیتا
મનીદીપ	منیدیب
મનુજ	منوج
મનોથ	منوته
મનોભાવ	منوبهاو
મન્કુર	منكور
મયુરીની	میورینی
મરીને	مریني
મલયજ	ملیج
મલ્લિકા	مللیكا
મલ્લિકાર્જુન	مللیكارجون
મલ્લિગા	مللیجا
મલ્લી	مللی
મલ્લુ	مللو
મસરા	مسرا
મહંથી	مهنتهی
મહાત્મન	مهاتمن
મહાનંદ	مهانند
મહાપુરુષ	مهابوروش
મહાબુદ્ધિ	مهابوددهی
મહાર્થ	مهارته
મહાર્વીન	مهاروین
મહાલીંગ	مهالینج
મહાલ્યા	مهالیا
મહાશ્રી	مهاشری
મહિપતિ	مهیبتی
મહીથા	مهیتها
મહેંદ્રા	مهیندرا
માંગેશ	مانجیش
માંધુનીકા	ماندهونیكا
માંનાર્પ	ماننارب
માંનીક્યા	ماننیكیا
માંનીચ	ماننیتش
માંનીવ	ماننیو
માંનુંસ્મીથા	ماننونسمیتها
માંનોત	ماننوت
માંન્ગીરી	ماننجیری
માંન્તીકા	ماننتیكا
માંન્દામારી	ماننداماری
માંન્દારિકા	ماننداریكا
માંલાવાશ્રી	مانلاواشری
માતંગા	ماتنجا
માતેઃ	ماتیها
માત્રે	ماتري
માથુર	ماتهور
માધવ દાસ	مادهو داس
માધવિલતા	مادهویلتا
માધાન	مادهان
માધુજ	مادهوج
માનજ	مانج
માનવિત	مانویت
માનીન્ત	مانینت
માન્દાવિક	مانداویك
મારવી	ماروی
મારીરાજ	ماریراج
મારુત	ماروت
માર્કાન્દાય	ماركاندای
માર્ગશી	مارجشی
માર્ગી	مارجی
માર્દવ	ماردو
માર્મિક	مارمیك
માલતી	مالتی
માલથી	مالتهی
માલારવિલી	مالارویلی
માલારાવન	مالاراون
માલિની	مالینی
માહિતા	ماهیتا
મેધાસ્વી	میدهاسوی
મૈથીલ્ય	مایتهیلی
મૈનાલી	ماینالی
મૈનાવી	مایناوی
મૈમત	مایمت
મૌલિકા	ماولیكا
મૌસુમ	ماوسوم
યજ્નારૂપ	یجناروب
યતિકા	یتیكا
યદુ	یدو
યદુક્રિષ્ના	یدوكریشنا
યદુવીર	یدوویر
યમ્યા	یمیا
યશિત	یشیت
યશોધર	یشودهر
યશ્દીપ	یشدیب
યશ્વી	یشوی
યાઝટ	یاجهط
યાતિયાસા	یاتییاسا
યામાજીત	یاماجیت
યાશીકા	یاشیكا
યાશ્રી	یاشری
યાસી	یاسی
યાહ્વી	یاهوی
યીશાઈ	ییشاإ
યુકાશ્રી	یوكاشری
યુક્ત	یوكت
યુગ	یوج
યુગંશ	یوجنش
યુગન	یوجن
યુગ્મ	یوجم
યુધાજિત	یودهاجیت
યુધિસઠિર	یودهیسطهیر
યુનાય	یونای
યુવંશ	یوونش
યુવાની	یووانی
યુવિક	یوویك
યૂરા	یورا
યેધાંત	ییدهانت
યેનાક્ષી	ییناكشی
યોગજ	یوجج
યોગદા	یوجدا
યોગના	یوجنا
યોગાવી	یوجاوی
યોગી	یوجی
યોગ્યથા	یوجیتها
યોનેન્દ્ર	یونیندر
યૌષા	یاوشا
રંગનાથ	رنجناته
રંતાજ	رنتاج
રકશ્ન્ડા	ركشندا
રકીશી	ركیشی
રક્તકમળ	ركتكمر
રક્ષ્ય	ركشی
રઘુનાથ	رجهوناته
રજીની	رجینی
રતન	رتن
રત્ના કુમાર	رتنا كومار
રત્નાબલી	رتنابلی
રત્નાવલી	رتناولی
રદીતે	ردیتي
રનક	رنك
રનવા	رنوا
રનામીતા	رنامیتا
રમિતા	رمیتا
રમેશ	رمیش
રમ્બેશ	رمبیش
રમ્યક	رمیك
રયાપ્પા	ریاببا
રવિકાંત	رویكانت
રવિકુમાર	رویكومار
રવીતેજા	رویتیجا
રવીન	روین
રવીન્ધાર	رویندهار
રવીશ	رویش
રવેન	روین
રશેષ	رشیش
રશ્મી	رشمی
રસવંત	رسونت
રહલ	رهل
રહસ્ય	رهسی
રાકવી	راكوی
રાખિ	راكهی
રાગાવર્દીની	راجاوردینی
રાગ્વેદ	راجوید
રાજન	راجن
રાજરમણ	راجرمن
રાજલક્ષ્મી	راجلكشمی
રાજસેકરણ	راجسیكرن
રાજાન	راجان
રાજિંદર	راجیندر
રાજુસ	راجوس
રાજેંદ્ર	راجیندر
રાજેશ્રી	راجیشری
રાજ્કલા	راجكلا
રાજ્યશ્રી	راجیشری
રાજ્વિકા	راجویكا
રાત્રિ	راتری
રાધક	رادهك
રાધા	رادها
રાનું	رانون
રામ	رام
રામ  સેવક	رام  سیوك
રામનાથ	رامناته
રામરા	رامرا
રામસ્વરૂપ	رامسوروب
રામાંભાદ્રણ	رامانبهادرن
રામાધુતા	رامادهوتا
રાવના	راونا
રાસબિહારી	راسبیهاری
રિન્કલ	رینكل
રિસા	ریسا
રીકાર્નાવ	ریكارناو
રીકીતા	ریكیتا
રીકીશા	ریكیشا
રીગ્વેદીતા	ریجویدیتا
રીથ	ریته
રીથેકા	ریتهیكا
રીધી	ریدهی
રીનું	رینون
રીન્સીન	رینسین
રીમા	ریما
રીશીતા	ریشیتا
રીહાનના	ریهاننا
રેચિકા	ریتشیكا
રેનેશ	رینیش
રેમિથા	ریمیتها
રેશમી	ریشمی
રોનક	رونك
લકી	لكی
લક્ષિતા	لكشیتا
લક્ષ્મી શ્રીનિવાસ	لكشمی شرینیواس
લક્ષ્મીદેવી	لكشمیدیوی
લક્ષ્મીનાથ	لكشمیناته
લગાન	لجان
લજ્જા	لججا
લજ્જાન	لججان
લજ્જાવતી	لججاوتی
લતા	لتا
લબોની	لبونی
લલિતામોહના	للیتاموهنا
લશિકા	لشیكا
લાઈના	لاإنا
લાકેશ	لاكیش
લાક્શેતા	لاكشیتا
લાચ્મન	لاتشمن
લાતીશ	لاتیش
લાધી	لادهی
લારીસા	لاریسا
લાર્મિકા	لارمیكا
લાલીતેશ	لالیتیش
લાલીત્યા	لالیتیا
લાલીમા	لالیما
લાવણ્ય	لاونی
લાવીશ	لاویش
લાસીવીન્રાજ	لاسیوینراج
લાસુશા	لاسوشا
લિંગાધ્યક્ષ	لینجادهیكش
લીકીથ	لیكیته
લીથીકા	لیتهیكا
લીનું	لینون
લીન્નેત	لیننیت
લીમીશા	لیمیشا
લીલાધર	لیلادهر
લીલાવર્તી	لیلاورتی
લીશાંત	لیشانت
લુંહાન	لونهان
લુકેશા	لوكیشا
લૂની	لونی
લેઓરા	لیاورا
લેખિત	لیكهیت
લેના	لینا
લેમ્મીએ	لیممیي
લોઉકિક	لووكیك
લોકનાથ	لوكناته
લોકનેત્ર	لوكنیتر
લોકાજિત	لوكاجیت
લોકેન્દ્ર	لوكیندر
લોક્ષી	لوكشی
લોપેશ	لوبیش
લોલા	لولا
લોલિતા	لولیتا
લોવ્યમ	لوویم
લોશીની	لوشینی
લોહિની	لوهینی
વંદિત	وندیت
વંશજા	ونشجا
વંહી	ونهی
વકૃત	وكرت
વક્ષ	وكش
વજરાંગ	وجرانج
વજ્રબાહૂ	وجرباهو
વજ્રાકાયા	وجراكایا
વજ્રિન	وجرین
વજ્રેશ્વરી	وجریشوری
વનદેવ	وندیو
વનાની	ونانی
વયુનંદ	ویونند
વય્યા	وییا
વરજોત્તામાં	ورجوتتامان
વરદરાજ	وردراج
વરદાન	وردان
વરપ્રદા	وربردا
વરલક્ષ્મી	ورلكشمی
વરિયાસ	ورییاس
વર્ધીન	وردهین
વર્શિની	ورشینی
વલાવન	ولاون
વલ્લભ	وللبه
વશીતા	وشیتا
વસંતા	وسنتا
વસતીન	وستین
વસવી	وسوی
વસુલ	وسول
વાક્પતિ	واكبتی
વાચસ્પતિ	واتشسبتی
વાચ્ય	واتشی
વાજ્રહાસ્તા	واجرهاستا
વાનામાલી	وانامالی
વાનાવારાયણ	واناواراین
વાનૈપકા-વેરીન્દોન	وانایبكا-ویریندون
વામન	وامن
વામાંનીએ	واماننیي
વાર	وار
વાલકય	والكی
વાલી	والی
વાસંતાપ્રભા	واسنتابربها
વાસુકી	واسوكی
વાસુમાંથા	واسومانتها
વિઅર	ویار
વિકાસીની	ویكاسینی
વિકાસ્ની	ویكاسنی
વિક્ષિત	ویكشیت
વિદ્વાથ	ویدواته
વિધિ	ویدهی
વિનતા	وینتا
વિબુષા	ویبوشا
વિભાવા	ویبهاوا
વિમલા	ویملا
વિરબાહુ	ویرباهو
વિલાસિની	ویلاسینی
વીક્ષા	ویكشا
વીચિકા	ویتشیكا
વીજીલા	ویجیلا
વીની	وینی
વીમા	ویما
વીરોત્તમ	ویروتتم
વેક્રાંત	ویكرانت
વેગવાહીની	ویجواهینی
વેણુગોપાલ	وینوجوبال
વેત્રિવાલ	ویتریوال
વેદાંશી	ویدانشی
વેદાત્મન	ویداتمن
વેદાત્મને	ویداتمني
વેદાર્થ	ویدارته
વેદીષ	ویدیش
વેધા	ویدها
વેધાસ	ویدهاس
વેધીકા	ویدهیكا
વેનાહ	ویناه
વેનીધર	وینیدهر
વેન્કાત્શીવા	وینكاتشیوا
વેન્નેલા	ویننیلا
વેલુ	ویلو
વેવેશા	ویویشا
વૈજનાથ	وایجناته
વૈદાહી	وایداهی
વૈદ્યનાથ	وایدیناته
વૈધે	وایدهي
વૈનાવિન	وایناوین
વૈશાકા	وایشاكا
વૈશાખી	وایشاكهی
વૈશાલી	وایشالی
વૈશ્વિક	وایشویك
વૈષ્ણવી	وایشنوی
વૈસાખી	وایساكهی
સંચાલી	سنتشالی
સંજય	سنجی
સંજીથા	سنجیتها
સંજુકતા	سنجوكتا
સંતવાના	سنتوانا
સંદીતી	سندیتی
સંદીપન	سندیبن
સંભાવના	سنبهاونا
સંયક્તા	سنیكتا
સંવિકા	سنویكا
સંસ્કૃતિ	سنسكرتی
સંસ્કૃતી	سنسكرتی
સકલ	سكل
સક્તીવેલ	سكتیویل
સક્શિક	سكشیك
સક્શીન્યા	سكشینیا
સક્ષમ	سكشم
સચંદ્ર	ستشندر
સજૂ	سجو
સદગુરૂ	سدجورو
સદબિંદુ	سدبیندو
સદરુ	سدرو
સદા શિવમ	سدا شیوم
સદાશિવ	سداشیو
સદિવા	سدیوا
સદ્વિખા	سدویكها
સનવ	سنو
સનીલ	سنیل
સનેશ	سنیش
સનૈતા	سنایتا
સપર્ણા	سبرنا
સપુષ્પા	سبوشبا
સપ્તોર્શી	سبتورشی
સબરીનાથાન	سبریناتهان
સભ્રાંત	سبهرانت
સમન્યુ	سمنیو
સમબરણ	سمبرن
સમભ્દ્ધા	سمبهددها
સમય	سمی
સમરવીર	سمرویر
સમાંર્ધ	سمانرده
સમાધાન	سمادهان
સમિયા	سمییا
સમીક્ક્સા	سمیككسا
સમીક્ષા	سمیكشا
સમ્બુદ્ધા	سمبوددها
સમ્યનાતન	سمیناتن
સમ્રીધ	سمریده
સમ્હીઠા	سمهیطها
સરલા	سرلا
સર્જના	سرجنا
સહલાદ	سهلاد
સહસ્ત્રજિત	سهسترجیت
સહસ્વીની	سهسوینی
સહુરી	سهوری
સહૃદય	سهردی
સહેજ	سهیج
સહોજ	سهوج
સહ્ય	سهی
સાંદીપની	ساندیبنی
સાઈ અમર્ત્ય	ساإ امرتی
સાઈ કાર્તિક	ساإ كارتیك
સાઈ દાસ	ساإ داس
સાઈ સુરિયા	ساإ سورییا
સાતેજ	ساتیج
સાદ્રીશી	سادریشی
સાધકા	سادهكا
સાધન	سادهن
સાનંદના	سانندنا
સાનવી તારીતા	سانوی تاریتا
સાનાવી	ساناوی
સાન્વી	سانوی
સાફલ્ય	سابهلی
સાબી	سابی
સામલી	ساملی
સામાન	سامان
સારંગી	سارنجی
સારસ	سارس
સારાવતી	ساراوتی
સાલીની	سالینی
સાહસ્રપાત	ساهسربات
સાહુલ	ساهول
સેન્ડી	سیندی
સૈનિ	ساینی
સૈનું	ساینون
સૈય્યન	ساییین
સૈલેન્દ્ર	سایلیندر
સૈશા	سایشا
હંસરાજ	هنسراج
હંસાવાથ્ય	هنساواتهی
હંસિન	هنسین
હંસીની	هنسینی
હઝેલ	هجهیل
હનસીકા	هنسیكا
હનાર્વીન	هناروین
હનુમાન	هنومان
હમૃથા	همرتها
હમ્સિની	همسینی
હરશું	هرشون
હરા	هرا
હરિઅક્સા	هریاكسا
હરિકિશન	هریكیشن
હરિદા	هریدا
હરિનાક્ષી	هریناكشی
હરિમંતી	هریمنتی
હરી	هری
હરી કિશન	هری كیشن
હરીકરણ	هریكرن
હરીદર્પા	هریدربا
હરીદાસાપ્રિયા	هریداسابرییا
હરીદીપ	هریدیب
હરીધામ	هریدهام
હરીવલ્લભ	هریوللبه
હરીશ્વ	هریشو
હર્લીના	هرلینا
હર્શાશ્રી	هرشاشری
હર્શિક	هرشیك
હર્ષ વીર	هرش ویر
હર્ષિતા	هرشیتا
હર્સ્વીતા	هرسویتا
હલેય	هلیی
હવીસા	هویسا
હશન	هشن
હસીક	هسیك
હસીથા	هسیتها
હસ્મીથા	هسمیتها
હાકેશ	هاكیش
હાનીકા	هانیكا
હાર્શીની	هارشینی
હાહન	هاهن
હિડિંબા	هیدینبا
હિતાંશી	هیتانشی
હિતેક્ષા	هیتیكشا
હિતેન્દ્ર	هیتیندر
હિનલ	هینل
હિનેશ	هینیش
હિમાકાર	هیماكار
હિમાઘ્ના	هیماجهنا
હિમાલ	هیمال
હિશા	هیشا
હિશેતા	هیشیتا
હીમીર	هیمیر
હીરકની	هیركنی
હીરાન્યાપ્પા	هیرانیاببا
હીર્નાક્ષી	هیرناكشی
હીલ્લેય	هیللیی
હુમીશા	هومیشا
હુમૈલા	هومایلا
હેઇઅન	هیإان
હેત	هیت
હેતની	هیتنی
હેતવ	هیتو
હેત્વિક	هیتویك
હેમંત	هیمنت
હેમદેવ	هیمدیو
હેમલતા	هیملتا
હેમા	هیما
હેમાઁગી	هیمانجی
હેમાંગા	هیمانجا
હેમાકેશ	هیماكیش
હેમાલા	هیمالا
હેમાલી	هیمالی
હેમાવતી	هیماوتی
હેમીતા	هیمیتا
હેયન	هیین
હેશીકા	هیشیكا
હોનહાર	هونهار
હ્રિથિક	هریتهیك
હ્રીત્વિકા	هریتویكا
હ્રીદાન	هریدان
હ્રીવાન	هریوان
હ્રીશાંત	هریشانت
હ્રીશાબ	هریشاب
હ્રીશુલ	هریشول
હ્રુધાઈ	هرودهاإ
