# Baby names
അകര്ശാനാ	اكرشانا
അക്ശൈനീഏ	اكشاینیي
അഗജാ	اججا
അചിംത	اتشینت
അചിത	اتشیت
അച്ചിന്ദ്ര	اتشتشیندر
അഡ്യാദവൈതാ	ادیادوایتا
അദഭുതഃ	ادبهوتها
അദേന്യ	ادینی
അദേല	ادیل
അദ്രിതീ	ادریتی
അദ്രീഥീ	ادریتهی
അദ്രീമാം	ادریمان
അദ്വൈയാ	ادواییا
അധര്ഷ	ادهرش
അധിപാ	ادهیبا
അധീരതാ	ادهیرتا
അധ്യുത	ادهیوت
അനംതാമായാ	اننتامایا
അബരനാ	ابرنا
അബിനയ	ابینی
അബിനാ	ابینا
അബീനംദാ	ابینندا
അബീശാ	ابیشا
അഭയ	ابهی
അഭയന	ابهین
അഭിഗ്ന്യാ	ابهیجنیا
അഭിജീതാ	ابهیجیتا
അഭിനിവേശ	ابهینیویش
അഭിമ	ابهیم
അഭിമാനീ	ابهیمانی
അഭിമോദാ	ابهیمیادا
അഭിരാ	ابهیرا
അഭിരാത	ابهیرات
അഭീരല	ابهیرل
അഭീശ്രേയ	ابهیشریی
അഭീസുമത	ابهیسومت
അഭ്യപ്സീത	ابهیبسیت
അഭ്യുദയാ	ابهیودیا
അമൃതാ	امرتا
അലകനംദാ	الكنندا
അലക്ഷാ	الكشا
അല്കാ	الكا
അശവ	اشو
അശ്നേഇല	اشنیيل
ആകാശലീനാ	آكاشلینا
ആകൃഥീ	آكرتهی
ആക്ഷ്യാ	آكشیا
ആചാര്യ	آتشاری
ആത്മയ	آتمی
ആദി	آدی
ആദിമ	آدیم
ആദീവ	آدیو
ആധീരേന	آدهیرین
ആധ്യാ	آدهیا
ആനംദീനീ	آنندینی
ആനീകാ	آنیكا
ആന്തീകാ	آنتیكا
ആന്വീ	آنوی
ആപ്ത	آبت
ആപ്തി	آبتی
ആമാംനീ	آماننی
ആമിഷ	آمیش
ആമുക്ഥാ	آموكتها
ആയുസ	آیوس
ആയോദ	آییاد
ആരംഭീ	آرنبهی
ആരതീ	آرتی
ആരസീ	آرسی
ആര്യ	آری
ആര്യക	آریك
ആര്യനാ	آرینا
ആര്യമാനീ	آریمانی
ആലേഃയാ	آلیهایا
ആവംശ	آونش
ആവേശ	آویش
ആശകാ	آشكا
ആശിയാനാ	آشییانا
ആശുതോഷ	آشوتیاش
ആശ്മീന	آشمین
ആശ്വിത	آشویت
ആസവ	آسو
ആസ്തിക	آستیك
ഇക്ശാനാ	إكشانا
ഇജയാ	إجیا
ഇനീയന	إنیین
ഇനോദയ	إنیادی
ഇന്ദരകാന്ത	إندركانت
ഇന്ദിവാരസ	إندیوارس
ഇന്ദുശിതാലാ	إندوشیتالا
ഇന്ദ്രജാ	إندرجا
ഇന്ദ്രതന	إندرتن
ഇന്ദ്രദയുമ്ന	إندردیومن
ഇന്ദ്രവദന	إندرودن
ഇന്ദ്രാണീ	إندرانی
ഇബ്ബാനീ	إببانی
ഇയുരേശ	إیوریش
ഇയേനഗര	إیینجر
ഇരാജ	إراج
ഇരിത	إریت
ഇരേശ	إریش
ഇലിസാ	إلیسا
ഇശിതാ	إشیتا
ഇശ്വാര്യ	إشواری
ഇഷ്ടാ	إشطا
ഇഷ്ടി	إشطی
ഇസാര	إسار
ഇസ്ശും	إسشون
ഈതന	إتن
ഈതികാ	إتیكا
ഈരേന്പ്രിത	إرینبریت
ഈര്ശീതാ	إرشیتا
ഈലാക്കീയാ	إلاككییا
ഈലികാ	إلیكا
ഈലേശാ	إلیشا
ഈശാര	إشار
ഈശിക	إشیك
ഈശ്വരദത്ത	إشوردتت
ഈഹാ	إها
ഉഗ്രസ്രവാസ	وجرسرواس
ഉജവണീ	وجونی
ഉജേശാ	وجیشا
ഉജ്ജന	وججن
ഉജ്ജവല	وججول
ഉജ്ജവാലാ	وججوالا
ഉജ്ജ്വലാ /ഉജ്വലാ	وججولا /وجولا
ഉജ്ജ്വാലാ	وججوالا
ഉത്കര്ഷ	وتكرش
ഉത്കലാ	وتكلا
ഉത്തര	وتتر
ഉത്പര	وتبر
ഉത്സര്ഗ	وتسرج
ഉദയ കുമാര	ودی كومار
ഉദരഥീ	ودرتهی
ഉദാന്തികാ	ودانتیكا
ഉദേയ	ودیی
ഉദ്ധാര	وددهار
ഉദ്യത	ودیت
ഉദ്യമീ	ودیمی
ഉദ്യോത	ودییات
ഉധവ	ودهو
ഉപംഗ	وبنج
ഉപദാ	وبدا
ഉപാധ്രീതീ	وبادهریتی
ഉപ്പാസ	وبباس
ഉമാ	وما
ഉമേശ്വര	ومیشور
ഉരിശിതാ	وریشیتا
ഉര്ജാ	ورجا
ഉര്ജീകാ	ورجیكا
ഉര്ജീതാ	ورجیتا
ഉര്ദാഹാവ	ورداهاو
ഉര്മികാ	ورمیكا
ഉര്മിമാലാ	ورمیمالا
ഉര്വീനാഥ	ورویناته
ഉല്പേശ	ولبیش
ഉശേന്യ	وشینی
ഉഷാശി	وشاشی
ഉഷ്മാ	وشما
ഉസരീ	وسری
ഊതരാ	وترا
ഊര്വേശ	ورویش
ഏകംശീ	یكنشی
ഏകക്ഷരപരാ	یككشربرا
ഏകതന	یكتن
ഏകതാ	یكتا
ഏകാംശ	یكانش
ഏകാകാന്യ	یكاكانی
ഏകാനീ	یكانی
ഏകാപര്നികാ	یكابرنیكا
ഏകേസ്വാര	یكیسوار
ഏത്തന	یتتن
ഏധിത	یدهیت
ഏമാ	یما
ഏലനാ	یلنا
ഏലാ	یلا
ഏലീലവേംദന	یلیلویندن
ഏലീലീ	یلیلی
ഓഈസീന	اويسین
ഓജസ്വീ	اوجسوی
ഓജാ	اوجا
ഓജീസ	اوجیس
ഓനിശ	اونیش
ഓമപ്രകാശ	اومبركاش
ഓവീന	اووین
ഓവൈസ	اووایس
കംജ	كنج
കംജന	كنجن
കംഠന	كنطهن
കംദര്പ	كندرب
കംപനാ	كنبنا
കകോന	ككیان
കതകീ	كتكی
കതേല്യ്ന	كتیلین
കനക	كنك
കനദ	كند
കനാകംഗീ	كناكنجی
കനീജാ	كنیجا
കനീരാ	كنیرا
കനീസാ	كنیسا
കനുഷ	كنوش
കന്വക	كنوك
കന്ശീകാ	كنشیكا
കപാലീന	كبالین
കപിലാശ്വര	كبیلاشور
കമലാപതി	كملابتی
കമലിനീ	كملینی
കമലേക്ഷണ	كملیكشن
കമ്നാ	كمنا
കരാലാ	كرالا
കരീസമാം	كریسمان
കരുനാസ്രീ	كروناسری
കരുപ്പസമ്യ	كروببسمی
കര്ണ	كرن
കര്തീഗാ	كرتیجا
കര്മദീപ	كرمدیب
കര്മാശ	كرماش
കലരനീ	كلرنی
കലശ	كلش
കലാധര	كلادهر
കലാനിധി	كلانیدهی
കലാപരണ	كلابرن
കലാപീന	كلابین
കലാപ്രിയാ	كلابرییا
കലൈസേലവീ	كلایسیلوی
കവന	كون
കവിപ  പ്രിയ	كویب  بریی
കവീനാഥ	كویناته
കശ്തീ	كشتی
കാജല	كاجل
കാജീശ	كاجیش
കാദമ്ബരീ	كادمبری
കാധിരോലീ	كادهیریالی
കാനീ	كانی
കാന്ജീരാ	كانجیرا
കാന്തീ	كانتی
കാമത	كامت
കാമിഷാ	كامیشا
കാമേശ	كامیش
കാരുണ്യ പ്രകാശ	كارونی بركاش
കാരൂകാ	كاروكا
കാര്നിക	كارنیك
കാലിക	كالیك
കാലിപദാ	كالیبدا
കാലിയാ	كالییا
കാലീതാ	كالیتا
കാവ്യ ശ്രീ	كاوی شری
കിന്നേരാ	كیننیرا
കീഅനാ	كیانا
കീജല	كیجل
കീനാരീ	كیناری
കീന്ചനാ	كینتشنا
കേകലാ	كیكلا
കേതന	كیتن
കേനിഷാ	كینیشا
കേളവ്യ	كیروی
കൈരവീ	كایروی
കൈലാശ	كایلاش
കോശേല	كیاشیل
കൌശികാ	كیشیكا
ഖഗേശ	كهجیش
ഖമീശ	كهمیش
ഖാതീരാവണ	كهاتیراون
ഖാത്വന്ഗീന	كهاتونجین
ഖീലതീ	كهیلتی
ഖുസീ	كهوسی
ഗംഗാ	جنجا
ഗംദേശാ	جندیشا
ഗംധാര	جندهار
ഗംധാരാ	جندهارا
ഗംധാലീ	جندهالی
ഗഗന	ججن
ഗജവദന	ججودن
ഗജേന്ദ്ര	ججیندر
ഗണക	جنك
ഗണനാ പംഡിതന	جننا بندیتن
ഗണനാഥ	جنناته
ഗണ്യാ	جنیا
ഗതി	جتی
ഗനേസന	جنیسن
ഗന്ഗസീരുവന	جنجسیروون
ഗയാലികാ	جیالیكا
ഗരിമാ	جریما
ഗരിഷ്ട	جریشط
ഗരുല	جرول
ഗാഇശ	جايش
ഗാന്ഗമൈന്ദന	جانجمایندن
ഗാമിനീ	جامینی
ഗായത്രീ	جایتری
ഗായലേ	جایلي
ഗിഅന	جیان
ഗിയാ	جییا
ഗിരിവര	جیریور
ഗീതി	جیتی
ഗീതീശാ	جیتیشا
ഗുംജാ	جونجا
ഗുനാജാ	جوناجا
ഗുനാരത്നാ	جونارتنا
ഗുനാശേകാര	جوناشیكار
ഗുനീന	جونین
ഗുന്ജീതാ	جونجیتا
ഗുപ്തക	جوبتك
ഗുരദയാല	جوردیال
ഗുരദേവ	جوردیو
ഗുരബാനീ	جوربانی
ഗുരമാന	جورمان
ഗുരുത്തമ	جوروتتم
ഗുര്നാന്ഡീശ	جورناندیش
ഗുലമോഹര	جولمیاهر
ഗുവീദ	جووید
ഗൂംജീതാ	جونجیتا
ഗൂഹാരീ	جوهاری
ഗേനേലിയാ	جینیلییا
ഗേശനാ	جیشنا
ഗോപാല	جیابال
ഗോപീ നാഥ	جیابی ناته
ഗോഭില	جیابهیل
ഗോരഖ-നാഥ	جیاركه-ناته
ഗൌരവീ	جیروی
ഗൌരീകാംത	جیریكانت
ഗൌരീശ	جیریش
ഗൌര്പ്രിയാ	جیربرییا
ഗ്രീതേശ	جریتیش
ഗ്രീവാ	جریوا
ഗ്രീശ്മീതാ	جریشمیتا
ഗ്രീഷ്മ	جریشم
ഘടോതകത്ചാ	جهطیاتكتتشا
ചംചലാ	تشنتشلا
ചംദേര്ഭാന	تشندیربهان
ചംദ്രകാംത	تشندركانت
ചംദ്രകാംതാ	تشندركانتا
ചംദ്രചുര	تشندرتشور
ചംദ്രപുശ്പാ	تشندربوشبا
ചംദ്രപ്രകാശ	تشندربركاش
ചംദ്രമതി	تشندرمتی
ചംദ്രലേഖാ	تشندرلیكها
ചംദ്രഹാസ	تشندرهاس
ചംദ്രാനന	تشندرانن
ചംദ്രാഭാ	تشندرابها
ചംദ്രേശ	تشندریش
ചകേശ	تشكیش
ചകോര	تشكیار
ചക്ഷസ	تشكشس
ചതുര	تشتور
ചതുരാ	تشتورا
ചതുര്ഭുജാ	تشتوربهوجا
ചതുര്വേദീ	تشتورویدی
ചത്രീയാ	تشترییا
ചന്ദ്രകേതു	تشندركیتو
ചരണ	تشرن
ചരന്യാ	تشرنیا
ചലാമാ	تشلاما
ചാംദ	تشاند
ചാനാസ്യാ	تشاناسیا
ചാനേ	تشاني
ചാന്ദനികാ	تشاندنیكا
ചാരുന	تشارون
ചാരുവീ	تشارووی
ചാര്മീ	تشارمی
ചാര്വീ	تشاروی
ചാവ്രിക	تشاوریك
ചിത്കലാ	تشیتكلا
ചിത്ത	تشیتت
ചിത്തപ്രസാദ	تشیتتبرساد
ചിത്തരംജന	تشیتترنجن
ചിത്തരംജനീ	تشیتترنجنی
ചിത്രകുന്ധാലാ	تشیتركوندهالا
ചിത്രകേതു	تشیتركیتو
ചിത്രഗംധാ	تشیترجندها
ചിത്രബാനാ	تشیتربانا
ചിത്രമാലാ	تشیترمالا
ചിത്രര്ത	تشیتررت
ചിത്രല	تشیترل
ചിത്രലേഖാ	تشیترلیكها
ചിത്രാദീപ	تشیترادیب
ചിത്രീനീ	تشیترینی
ചിദംബര	تشیدنبر
ചിദാനംദാ	تشیدانندا
ചിനാര	تشینار
ചിന്നാദുരാഈ	تشیننادوراي
ചിമന	تشیمن
ചീദാര്ത	تشیدارت
ചീന്മയേ	تشینمیي
ചീരുഷ	تشیروش
ചേതന്ദീപ	تشیتندیب
ചേതള	تشیتر
ചേഥാസാ	تشیتهاسا
ചേമ്മല	تشیممل
ചേര്വിക	تشیرویك
ചേലന	تشیلن
ചേലിയാഁ	تشیلییاഁ
ചൈതന്യാ	تشایتنیا
ചൈത്രാ	تشایترا
ചൈരാവലീ	تشایراولی
ഛായാംക	تشهایانك
ജക്ഷ	جكش
ജക്ഷാനീ	جكشانی
ജഗതപ്രകാശ	ججتبركاش
ജഗദഗുരു	ججدجورو
ജഗദമ്ബാ	ججدمبا
ജഗനമോഹിനീ	ججنمیاهینی
ജഗന്മയീ	ججنمیی
ജഗ്വീ	ججوی
ജഗ്വീര	ججویر
ജജ്വാല്യാ	ججوالیا
ജടായു	جطایو
ജനഹിതാ	جنهیتا
ജനാദേവ	جنادیو
ജനാവ	جناو
ജനിത	جنیت
ജമാംദാഗ്ന്യ മഹാദാര്പാ	جمانداجنی مهاداربا
ജമ്ബവതപ്രീതി	جمبوتبریتی
ജയംത	جینت
ജയചംദ	جیتشند
ജയപാല	جیبال
ജയമാലാ	جیمالا
ജയശ്രീ	جیشری
ജയാകീര്തന	جیاكیرتن
ജയാകേതന	جیاكیتن
ജയാപാദമാം	جیابادمان
ജയായ	جیای
ജയിത	جییت
ജയേശ	جییش
ജലദ	جلد
ജല്പേശ	جلبیش
ജശവംത	جشونت
ജസീത്താ	جسیتتا
ജസ്സീ	جسسی
ജാനകീ	جانكی
ജാനകീദാസ	جانكیداس
ജാനകീനാഥ	جانكیناته
ജാനകീഭൂഷണ	جانكیبهوشن
ജാനഹിതാ	جانهیتا
ജാപക	جابك
ജായിത്രീ	جاییتری
ജിനേശ്വര	جینیشور
ജിഹാന	جیهان
ജീതേശ	جیتیش
ജീന്ദാല	جیندال
ജീവനകലാ	جیونكلا
ജീവനീ	جیونی
ജീവന്തീനീ	جیونتینی
ജുഷ്ടി	جوشطی
ജേനീശാ	جینیشا
ജേര്ശീകാ	جیرشیكا
ജൈകാപിശ	جایكابیش
ജൈചരണ	جایتشرن
ജൈനീശ	جاینیش
ജൈപ്രകാശ	جایبركاش
ജൈവംത	جایونت
ജൈസല	جایسل
ജൈഹാസീനീ	جایهاسینی
ജോംഫീ	جیانبهی
ജോശനീകാ	جیاشنیكا
ജോശീതാ	جیاشیتا
ജ്വാലാ	جوالا
ജ്ഹില	جهیل
ജ്ഹീണൂക	جهینوك
ഝഹനവീ	جههنوی
ഝാനീശാ	جهانیشا
ഝാരാ	جهارا
ഝീയാ	جهییا
ഝേനീശാ	جهینیشا
ഝ്യാനനീ	جهیاننی
ടീംകു	طینكو
ഠുമരീ	طهومری
തക്ശീ	تكشی
തക്ശീല	تكشیل
തജജ്ഞ	تججن
തനവീ	تنوی
തനിഷ്ക	تنیشك
തനുംജാശ്രീ	تنونجاشری
തനുംശ്കാ	تنونشكا
തനോജ	تنیاج
തപസ	تبس
തപസ്വിനീ	تبسوینی
തമില  സേല്വീ	تمیل  سیلوی
തമിശ	تمیش
തമോഘ്നാ	تمیاجهنا
തമോനഷ	تمیانش
തരംജോത	ترنجیات
തരനീ	ترنی
തരലാ	ترلا
തരീനീ	ترینی
തരുശ്രീ	تروشری
തരൂണീ	ترونی
തവിഷാ	تویشا
തസ്യ	تسی
താക്ഷ്യാ	تاكشیا
താജേന്ദര	تاجیندر
താനാരുപീ	تاناروبی
താനിയാ	تانییا
താന്വീഥാ	تانویتها
താപീ	تابی
താരികാ	تاریكا
താരീനീ	تارینی
താരൂശ	تاروش
താലംക	تالنك
താലീന	تالین
താലേശ	تالیش
താവന	تاون
താവീശാ	تاویشا
തിതലീ	تیتلی
തിനാശ	تیناش
തിലക	تیلك
തീഈവ്യേശ	تیيوییش
തീര്ഥാ	تیرتها
തീസ്ചാ	تیستشا
തുത്തീ	توتتی
തുനാവാ	توناوا
തുന്ഗാര	تونجار
തുപമ	توبم
തുരഗ	تورج
തുശീഥാ	توشیتها
തൃപേശ	تربیش
തേജസ	تیجس
തേജസ്വീ	تیجسوی
തേജസ്വീന	تیجسوین
തേജേനദര	تیجیندر
തേജോമയ	تیجیامی
തോയേശ	تیاییش
തോശീകാ	تیاشیكا
തൌരുസ	تیروس
ത്രികായാ	تریكایا
ത്രിപുരസുംദരീ	تریبورسوندری
ത്രിഭുവന	تریبهوون
ത്രിമാന	تریمان
ത്രിമൂര്തി	تریمورتی
ത്രിവേണീ	تریوینی
ത്രിശല	تریشل
ത്രിശലാനാ	تریشلانا
ത്രീഝ്യാ	تریجهیا
ത്രീതിയാ	تریتییا
ത്രീനേശ	ترینیش
ത്രീപന	تریبن
ത്രീപ്ത	تریبت
ത്രീവീദ	تریوید
ത്വരിതാ	توریتا
ത്വീശീ	تویشی
ത്വേസാ	تویسا
ഥംസീ	تهنسی
ഥനീരികാ	تهنیریكا
ഥാകാപ്പന്സ്വാമീ	تهاكاببنسوامی
ഥാരികാ	تهاریكا
ഥാവനീ	تهاونی
ഥീരീശ്കാ	تهیریشكا
ഥുസീഥാ	تهوسیتها
ഥ്രേശാ	تهریشا
ദംദാപാനീ	دندابانی
ദക്ഷാഹതാ	دكشاهتا
ദബീത	دبیت
ദബ്ന്ശും	دبنشون
ദയാദാ	دیادا
ദയാനിതാ	دیانیتا
ദരഹാസ	درهاس
ദര്ശ	درش
ദര്ശക	درشك
ദര്ശികാ	درشیكا
ദര്ശീനീ	درشینی
ദര്സീകാ	درسیكا
ദശാഗ്രീവാ ശീരോഹരാ	دشاجریوا شیریاهرا
ദശാഗ്രീവാകുലാന്താകാ	دشاجریواكولانتاكا
ദശാനന	دشانن
ദഹാ	دها
ദാനാസ്വീ	داناسوی
ദാനുംശ്രീ	دانونشری
ദാന്ദാകാരാന്യ പുന്യകൃതേ	دانداكارانی بونیكرتي
ദാരുല	دارول
ദാഹക	داهك
ദികീശംദ	دیكیشند
ദിഗീശാ	دیجیشا
ദിപംശീ	دیبنشی
ദിപശീകീ	دیبشیكی
ദിപേംദര	دیبیندر
ദിപ്താ	دیبتا
ദിബസരീ	دیبسری
ദിവീഥാ	دیویتها
ദിവേനാ	دیوینا
ദീതാ	دیتا
ദീനബംധു	دینبندهو
ദീപഥീ	دیبتهی
ദീപപ്രഭാ	دیببربها
ദീപമാലാ	دیبمالا
ദീപശിഖാ	دیبشیكها
ദീപാംജലി	دیبانجلی
ദീപാശാ	دیباشا
ദീപിത	دیبیت
ദീവാംശ	دیوانش
ദേജ	دیج
ദേബജ്യോതീ	دیبجییاتی
ദേബദാത്താ	دیبداتتا
ദേബദ്രിതാ	دیبدریتا
ദേബന്ശീ	دیبنشی
ദേയ്വയാനാകാന്തന	دییویاناكانتن
ദേവഗര്ഭാ	دیوجربها
ദേവജ്യോതി	دیوجییاتی
ദേവദാന	دیودان
ദേവന്ദ്ര	دیوندر
ദേവമദാനാ	دیومدانا
ദേവരാജ	دیوراج
ദേവശ്രീ	دیوشری
ദേവാംഗനാ	دیوانجنا
ദേവാംഗീ	دیوانجی
ദേവാംശു	دیوانشو
ദേവാദീത്യാ	دیوادیتیا
ദേവാനീ	دیوانی
ദേവാന്ശാ	دیوانشا
ദേവാപ്രിയാ	دیوابرییا
ദേവാമനോഹാരീ	دیوامنیاهاری
ദേവീന	دیوین
ദേവീലാല	دیویلال
ദേവേന	دیوین
ദേവേശീ	دیویشی
ദേവ്യഹ്നാന	دیویهنان
ദേശാവംത	دیشاونت
ദൈത്യാകുലാന്താകാ	دایتیاكولانتاكا
ദൈവ്യാ	دایویا
ധക്ശീന്യ	دهكشینی
ധനസുഖ	دهنسوكه
ധനാജീ	دهناجی
ധനിഷ്ഠ	دهنیشطه
ധനു	دهنو
ധനുജാ	دهنوجا
ധനേശീ	دهنیشی
ധന്വികാ	دهنویكا
ധരമനിഷ്ഠ	دهرمنیشطه
ധരാമാം	دهرامان
ധരാഹാസീനീ	دهراهاسینی
ധരീശ	دهریش
ധര്മ  ദുത്ത	دهرم  دوتت
ധര്മഅധ്യക്ഷ	دهرمادهیكش
ധര്മദിത്യ	دهرمدیتی
ധര്മദേവ	دهرمدیو
ധര്ശീതാ	دهرشیتا
ധര്ശീനീ	دهرشینی
ധാമീനീ	دهامینی
ധാരാനീ	دهارانی
ധിതി	دهیتی
ധിതീ	دهیتی
ധീപ്ത്ഹാ	دهیبتها
ധീമാഹീ	دهیماهی
ധീര്ഥാ	دهیرتها
ധേയാംശീ	دهییانشی
ധൈര്യ്യാ	دهایرییا
ധ്യുഥീ	دهیوتهی
ധ്രുമീ	دهرومی
നംദക	نندك
നംദു	نندو
നക്ശ	نكش
നക്സത്രരാജാ	نكسترراجا
നഗമാനീ	نجمانی
നടവര	نطور
നത്രീശാ	نتریشا
നദീപ	ندیب
നഭാ	نبها
നഭോമാനീ	نبهیامانی
നമന	نمن
നമനാ	نمنا
നയന	نین
നരേന്ദ്രന	نریندرن
നരേന്ദ്രനാഥ	نریندرناته
നരേശ	نریش
നവനീത വിലീപ്തംഗാ	نونیت ویلیبتنجا
നവമ	نوم
നവരംഗ	نورنج
നസീബ	نسیب
നാംബീ	نانبی
നാഗനാഥ	ناجناته
നാഗപാല	ناجبال
നാഗേശ്വരണ	ناجیشورن
നാഗൈഃ	ناجایها
നാതാഭൈരവീ	ناتابهایروی
നാതിന	ناتین
നാന്ധീനീ	ناندهینی
നാന്നാന	ناننان
നാഭിതാ	نابهیتا
നാഭേംദു	نابهیندو
നാമത	نامت
നായകീ	نایكی
നായാനീ	نایانی
നായാനീകാ	نایانیكا
നാലിനികാംത	نالینیكانت
നാലീനേശയ	نالینیشی
നാവീന്യ	ناوینی
നാവീല	ناویل
നാവ്യാ ദുര്ഗാ	ناویا دورجا
നാവ്രീതാ	ناوریتا
നികാരാ	نیكارا
നിഖിതാ	نیكهیتا
നിഖില	نیكهیل
നിജു	نیجو
നിധി	نیدهی
നിധിപാ	نیدهیبا
നിപാ	نیبا
നിരംജനാ	نیرنجنا
നിരമഈ	نیرمي
നിരുപമാ	نیروبما
നിര്മളാ	نیرمرا
നിര്മിതി	نیرمیتی
നിലാശാ	نیلاشا
നിശാനഥീ	نیشانتهی
നീഗീഥാ	نیجیتها
നീതു	نیتو
നീഥീകാ	نیتهیكا
നീധാ	نیدها
നീധാര്സനാ	نیدهارسنا
നീമാംലന	نیمانلن
നീരാലികാ	نیرالیكا
നീരൈമാംഥീ	نیرایمانتهی
നീര്മുകതാ	نیرموكتا
നീല മാധവ	نیل مادهو
നീലംജന	نیلنجن
നീലക്ഷ	نیلكش
നീല്ജാ	نیلجا
നീശാലീ	نیشالی
നീശീതീ	نیشیتی
നീശ്മീഥാ	نیشمیتها
നീസ്ചീഥാ	نیستشیتها
നീഹാ	نیها
നേമീശാ	نیمیشا
നേയ്സാ	نییسا
നേരീശാ	نیریشا
നൈജാ	نایجا
നൈരീതീ	نایریتی
നൈവേധീ	نایویدهی
നൌസദ	نیسد
പംകജന	بنكجن
പംചഭൂതാത്മികാ	بنتشبهوتاتمیكا
പംഥീനീ	بنتهینی
പഝ്ഹേനീ	بجههینی
പത്താമ്ബരാപരീധാനാ	بتتامبرابریدهانا
പത്ര	بتر
പന്ദാലാവാസന	بندالاواسن
പമ്പാ	بمبا
പമ്ഫാ	بمبها
പയാസ	بیاس
പയോധീ	بییادهی
പരംതാപാ	برنتابا
പരമാംത്മികാ	برمانتمیكا
പരമാംന്ത്ര	برماننتر
പരമിലാ	برمیلا
പരമേശ്വരീ	برمیشوری
പരമ്വാര്ദാന	برمواردان
പരവാനീ	بروانی
പരവിംദര	برویندر
പരാകാഷ	براكاش
പരാവീ	براوی
പരിഹാ	بریها
പര്തീബന	برتیبن
പര്ലീ	برلی
പര്വ	برو
പലാക്ഷ	بلاكش
പലാശീനീ	بلاشینی
പവന	بون
പവനസുത	بونسوت
പശുപതി	بشوبتی
പഹലാജ	بهلاج
പാടലാ	باطلا
പാന്ദുരംഗാ	باندورنجا
പായല	بایل
പാരു	بارو
പാര്ഥിക	بارتهیك
പാര്ഥീവീ	بارتهیوی
പാര്ഥോ	بارتهیا
പാളവീ	باروی
പാവകീ	باوكی
പാവനാ	باونا
പാവാനാ	باوانا
പാഹീ	باهی
പിവാല	بیوال
പൂജന	بوجن
പൂരതീ	بورتی
പൂരികാ	بوریكا
പൂര്വജാ	بوروجا
പൂര്വികാ	بورویكا
പേഖമ	بیكهم
പേത്ചീ	بیتتشی
പേരാരസീ	بیرارسی
പ്രകൃഥീ	بركرتهی
പ്രഗന്യാ	برجنیا
പ്രഗ്യപരാമിതാ	برجیبرامیتا
പ്രജാനാ	برجانا
പ്രനാദാ	برنادا
പ്രനീധാനാ	برنیدهانا
പ്രബകരണ	بربكرن
പ്രഭാകര	بربهاكر
പ്രഭാകരന	بربهاكرن
പ്രഭാത	بربهات
പ്രഭാവ	بربهاو
പ്രാതീകാ	براتیكا
ഫനീ	بهنی
ഫനീഭുഷണ	بهنیبهوشن
ഫാല്ഗുനീ	بهالجونی
ഫൂലന	بهولن
ഫ്രാന്ചീസ	بهرانتشیس
ബംദിശ	بندیش
ബംധൂല	بندهول
ബംശീ	بنشی
ബംസീധര	بنسیدهر
ബകുലാ	بكولا
ബകൂല	بكول
ബദ്രീ	بدری
ബനജ	بنج
ബനവാരീ	بنواری
ബബന	ببن
ബബിശ	ببیش
ബര്ഹന	برهن
ബലബീര	بلبیر
ബഹവാസ്യ	بهواسی
ബാബു	بابو
ബാബുല	بابول
ബാല മുകുന്ദ	بال موكوند
ബാലധി	بالدهی
ബാലാമോഹന	بالامیاهن
ബാലാരാജ	بالاراج
ബാലാശംകര	بالاشنكر
ബാലു	بالو
ബാലേന്ദു	بالیندو
ബാസ്കാര	باسكار
ബിനീതാ	بینیتا
ബീനും	بینون
ബീന്ദുശ്രീ	بیندوشری
ബീന്നീകേര	بیننیكیر
ബീപുല	بیبول
ബീബീന	بیبین
ബീരത	بیرت
ബീഹാന	بیهان
ബേനീതാ	بینیتا
ബേനും	بینون
ബേലുരമീ	بیلورمی
ബേല്ലീ	بیللی
ബൈവാവീ	بایواوی
ബൈസാഖീ	بایساكهی
ബ്രീഥ്ഹീ	بریتههی
ബ്ലേസ്സീ	بلیسسی
ഭഗവാന	بهجوان
ഭദ്രക്ഷ	بهدركش
ഭദ്രനിധി	بهدرنیدهی
ഭദ്രപ്രിയാ	بهدربرییا
ഭദ്രിക	بهدریك
ഭദ്രീശാ	بهدریشا
ഭവാനീ	بهوانی
ഭവ്യരാജ	بهویراج
ഭാഗവംതീ	بهاجونتی
ഭാദരന	بهادرن
ഭാനുമിത്ര	بهانومیتر
ഭാരഥീ	بهارتهی
ഭാര്ഗവന	بهارجون
ഭാര്ഗവാ	بهارجوا
ഭാര്ഘവീ	بهارجهوی
ഭാര്ദ്ദ്വാജ	بهارددواج
ഭാലേംദ്ര	بهالیندر
ഭാവതീ	بهاوتی
ഭാവീഗുരും	بهاویجورون
ഭാവ്യമ	بهاویم
ഭാശ്വീനീ	بهاشوینی
ഭാസു	بهاسو
ഭാസ്കാരീ	بهاسكاری
ഭാസ്കേര	بهاسكیر
ഭീമശംകര	بهیمشنكر
ഭൂദേവ	بهودیو
ഭൂപത	بهوبت
ഭൂപാല	بهوبال
ഭൂമാ	بهوما
ഭൂമാം	بهومان
ഭേരേശ	بهیریش
ഭൈരവീ	بهایروی
മംഗലമ	منجلم
മംഗേശ	منجیش
മംജു  പ്രസന്ന	منجو  برسنن
മംജുനാഥ	منجوناته
മംജുലാ	منجولا
മംത	منت
മംതോഷ	منتیاش
മംദിഥാ	مندیتها
മംദിരാ	مندیرا
മകാലീ	مكالی
മകുര	مكور
മഗന	مجن
മണികാംത	منیكانت
മദുരാ	مدورا
മധുനിഷാ	مدهونیشا
മധുമാംലീ	مدهومانلی
മധുരിമാ	مدهوریما
മധുവംതീ	مدهوونتی
മനജീത	منجیت
മനപ	منب
മനസ്വിന	منسوین
മനാല്പ	منالب
മനീതാ	منیتا
മനീഷ	منیش
മനോജ	منیاج
മനോരനജനീ	منیارنجنی
മനോരിഥാ	منیاریتها
മന്നത	مننت
മന്മായീ	منمایی
മല്ലികാ	مللیكا
മഹംത	مهنت
മഹാതപസ്വീ	مهاتبسوی
മഹാദുര്ഗാ	مهادورجا
മഹാദേവാ	مهادیوا
മഹാദേവാദീപുജീതാ	مهادیوادیبوجیتا
മഹാന്തേശ	مهانتیش
മഹാബാലാ	مهابالا
മഹാസ്വേതാ	مهاسویتا
മഹിപതി	مهیبتی
മഹിഷാസുരമര്ദിനീ	مهیشاسورمردینی
മഹീജിത	مهیجیت
മഹേംദ്രാ	مهیندرا
മഹേശ	مهیش
മഹേശനീ	مهیشنی
മഹേശീ	مهیشی
മാംതിക	مانتیك
മാംനീമോഝ്ഹീ	ماننیمیاجههی
മാംനുസരീ	ماننوسری
മാംന്ക്ഷ	ماننكش
മാംന്ഗീരീ	ماننجیری
മാംന്താവ്യാഹ	ماننتاویاه
മാംന്തീകാ	ماننتیكا
മാംന്ദീതാ	مانندیتا
മാംലാമാംകാല മകാന	مانلامانكال مكان
മാഇല	مايل
മാനകാ	مانكا
മാനജ	مانج
മാനശ	مانش
മാനിക	مانیك
മാനീശീന	مانیشین
മാനോരിത	مانیاریت
മാന്കന	مانكن
മാന്ദാവിക	مانداویك
മായാ	مایا
മാര്ഗശീ	مارجشی
മാര്ഗീ	مارجی
മാര്തംദ	مارتند
മാര്ഥീകാ	مارتهیكا
മാര്യ	ماری
മാര്യാ	ماریا
മാര്ഷാ	مارشا
മാലാര്കോഡീ	مالاركیادی
മാലിനീ	مالینی
മാല്ലേശാ	ماللیشا
മാസൂമ	ماسوم
മാസൂമീ	ماسومی
മാഹിയാ	ماهییا
മാഹിരാജ	ماهیراج
മാഹുലീ	ماهولی
മിലീ	میلی
മിഹീകാ	میهیكا
മീനാ	مینا
മേധ	میده
മേധീനീ	میدهینی
മൈത്രായ	مایترای
മൌലീശാ	میلیشا
മ്യ്ഥിലീ	میتهیلی
യംശ	ینش
യക്ഷ	یكش
യജും	یجون
യജുസ	یجوس
യജ്നേശ	یجنیش
യഥാര്ഥ	یتهارته
യദുനംദന	یدونندن
യശസ്വിനീ	یشسوینی
യശാശ്രീ	یشاشری
യശ്ദീപ	یشدیب
യശ്മിത	یشمیت
യശ്മിതാ	یشمیتا
യശ്വാര്ധാനാ	یشواردهانا
യശ്വീന	یشوین
യശ്വീനീ	یشوینی
യസ്വംഥ	یسونته
യാക്സീനീ	یاكسینی
യാഗ്നാകായാ	یاجناكایا
യാഗ്നീഥാ	یاجنیتها
യാചന	یاتشن
യാതീരാജു	یاتیراجو
യാദവീ	یادوی
യാദവേന്ദ്ര	یادویندر
യാന്തി	یانتی
യാശ്രീഥാ	یاشریتها
യാഷ്ക	یاشك
യാസസ്വീ	یاسسوی
യുഗന്തീകാ	یوجنتیكا
യുഗപ	یوجب
യുഗാന്ധര	یوجاندهر
യുതി	یوتی
യുവംശ	یوونش
യുവനാഥ	یووناته
യുവല	یوول
യുവാഥീ	یوواتهی
യുവാന  സൂര്യ	یووان  سوری
യുവ്നീക	یوونیك
യേര്രപ്പാ	ییررببا
യേശനാ	ییشنا
യേശാസ്വീനീ	ییشاسوینی
യേസസരീ	ییسسری
യോഗദേവാ	ییاجدیوا
യോഗരാജ	ییاجراج
യോഗാനംദ	ییاجانند
യോഗിത	ییاجیت
യോഗിതാ	ییاجیتا
യോഗിഥ	ییاجیته
യോഗേശ്വര	ییاجیشور
യോഗ്ദീപ	ییاجدیب
യോത്ശനാ	ییاتشنا
യോനേന്ദ്ര	ییانیندر
യോഹ്ശീനീ	ییاهشینی
യൌവാനീ	ییوانی
രംഗനാഥ	رنجناته
രംജന	رنجن
രംജികാ	رنجیكا
രംജീവ	رنجیو
രഈര്ഥ	ريرته
രക്ത	ركت
രക്തകമള	ركتكمر
രക്ഷികാ	ركشیكا
രക്ഷിത	ركشیت
രഘവാ	رجهوا
രഘവേന്ദര	رجهویندر
രഘുനാഥ	رجهوناته
രജത	رجت
രജനീശ	رجنیش
രജനേശ	رجنیش
രജീത	رجیت
രതന	رتن
രതാംജലി	رتانجلی
രതീക	رتیك
രതുല	رتول
രത്നാകര	رتناكر
രത്നാബലീ	رتنابلی
രഥനാ	رتهنا
രന്യ	رنی
രന്വിഥാ	رنویتها
രബേക	ربیك
രമാംസ്വമ്യ	رمانسومی
രമ്ബേശ	رمبیش
രയാന	ریان
രര്ശ്മീതാ	ررشمیتا
രവി കാന്ത	روی كانت
രവികാംത	رویكانت
രവിത	رویت
രവീജാ	رویجا
രവീനാ	روینا
രവ്യംകീ	روینكی
രശീലാ	رشیلا
രസവംത	رسونت
രസ്മീന	رسمین
രാഈ കുമാര	راي كومار
രാഖീ	راكهی
രാഗാവ	راجاو
രാഗിനീ	راجینی
രാഗേശ	راجیش
രാഗ്വേദ	راجوید
രാജക	راجك
രാജകന്യാ	راجكنیا
രാജഗോപാല	راججیابال
രാജയവര്ദന	راجیوردن
രാജാ	راجا
രാജാര്ശീ	راجارشی
രാജികാ	راجیكا
രാജീവ	راجیو
രാജേംദ്രമോഹന	راجیندرمیاهن
രാജേശ്വര	راجیشور
രാജ്യശ്രീ	راجیشری
രാധാനീ	رادهانی
രാനീ	رانی
രാമ  കീന്കാര	رام  كینكار
രാമഗോപാല	رامجیابال
രാമചന്ദ്രന	رامتشندرن
രാമനാരായണ	رامناراین
രാമരാ	رامرا
രാമരാജ	رامراج
രാമാംസുഗ്രീവാ	رامانسوجریوا
രാമാനംദ	رامانند
രാമാനുജമ	رامانوجم
രാമോജീ	رامیاجی
രാഹിത്യ	راهیتی
രാഹീന്യ	راهینی
രാഹുലരാജ	راهولراج
രിദ്ധി	ریددهی
രീചികാ	ریتشیكا
രീതൂ	ریتو
രീഥേകാ	ریتهیكا
രീദേവ	ریدیو
രീധമാം	ریدهمان
രീഭ്യാ	ریبهیا
രീശും	ریشون
രീശ്മേഥാ	ریشمیتها
രേഖാ	ریكها
രേത്വിക	ریتویك
രേധാ	ریدها
രേനാ	رینا
രേനേശ	رینیش
രേമാംനീകാ	ریماننیكا
രേമീ	ریمی
രേവാതീ	ریواتی
രേവീഥാ	ریویتها
രേശമീ	ریشمی
രേശ്വീന	ریشوین
രേഹാംശീ	ریهانشی
രേഹാനാ	ریهانا
രേഹേഈലാ	ریهیيلا
രേഹ്നുഘാ	ریهنوجها
രൈവത	رایوت
രൈവതാ	رایوتا
ലംഗീത	لنجیت
ലക്ഷ	لكش
ലക്ഷാകീ	لكشاكی
ലക്ഷിതാ	لكشیتا
ലക്ഷ്മീകാനതമ	لكشمیكانتم
ലജ്ജാ	لججا
ലജ്ജാകാ	لججاكا
ലതാ	لتا
ലതേശ	لتیش
ലവപാല	لوبال
ലവലീന	لولین
ലഹരീ	لهری
ലാക്ശേതാ	لاكشیتا
ലാജവംതീ	لاجونتی
ലാതീശ	لاتیش
ലാനീബന	لانیبن
ലാഭാ	لابها
ലാമ്ബോധാര	لامبیادهار
ലാരീനാ	لارینا
ലാര്മികാ	لارمیكا
ലാര്രാജ	لارراج
ലാര്ശന	لارشن
ലാവനീ	لاونی
ലാവിനാ	لاوینا
ലീകേശ	لیكیش
ലീത്സാ	لیتسا
ലീനാശാ	لیناشا
ലീനീത	لینیت
ലീപാക്ഷീ	لیباكشی
ലീപ്സീകാ	لیبسیكا
ലീമനാ	لیمنا
ലീലാമഈ	لیلامي
ലീശാംത	لیشانت
ലുസിയാ	لوسییا
ലേഈവീനാ	لیيوینا
ലേഖീശാ	لیكهیشا
ലേമാര	لیمار
ലോകനേത്ര	لیاكنیتر
ലോകാജനാനീ	لیاكاجنانی
ലോകാമാത്രീ	لیاكاماتری
ലോകീഥാ	لیاكیتها
ലോകേന്ദ്ര	لیاكیندر
ലോഗീനീ	لیاجینی
ലോഗേശ്വരണ	لیاجیشورن
ലോചനാ	لیاتشنا
ലോനാ	لیانا
ലോമാംകേശ	لیامانكیش
ലോഹിത	لیاهیت
ലോഹിതാശ്വാ	لیاهیتاشوا
ലൌക്യ	لیكی
വംദിതാ	وندیتا
വംസികൃഷ്ണ	ونسیكرشن
വനദ	وند
വനമാംഥീ	ونمانتهی
വനസ	ونس
വനിനാധ	ونیناده
വന്ജുല	ونجول
വപുസ	وبوس
വയദീശ	ویدیش
വരലീ	ورلی
വരിന	ورین
വരിയാസ	ورییاس
വരുന	ورون
വരുനികാ	ورونیكا
വര്ണിത	ورنیت
വര്ധമാന	وردهمان
വര്ധാനീ	وردهانی
വര്ധീമൈനകാപുജീതാ	وردهیماینكابوجیتا
വര്നീശാ	ورنیشا
വര്ശനേയാ	ورشنییا
വര്ശീകാ	ورشیكا
വര്ശീതാ	ورشیتا
വര്ശീദ	ورشید
വര്ഷനീ	ورشنی
വല്ലികാ	وللیكا
വസംതാ	وسنتا
വസംതീ	وسنتی
വസീസതാ	وسیستا
വസുമിത്ര	وسومیتر
വസുസേന	وسوسین
വാക്പതി	واكبتی
വാക്ഷു	واكشو
വാച്യ	واتشی
വാജ്രക്ഷ	واجركش
വാതത്മാജ	واتتماج
വാത്സല്യ	واتسلی
വാദിവേലും	وادیویلون
വാനര	وانر
വാന്ശുല	وانشول
വാമന	وامن
വാമാംക്ഷീ	وامانكشی
വാമീല	وامیل
വാരനാ	وارنا
വാരുനീ	وارونی
വാലാരമാംഥീ	والارمانتهی
വാല്ല്മാംനാലന	واللماننالن
വാശു	واشو
വാസുമന	واسومن
വാഹിനീ	واهینی
വികീശാ	ویكیشا
വിക്ഷിത	ویكشیت
വിജയാലക്ഷ്മീ	ویجیالكشمی
വിജയാശാനഥീ	ویجیاشانتهی
വിജീതാ	ویجیتا
വിദിശാ	ویدیشا
വിദ്യാ	ویدیا
വിദ്യുല	ویدیول
വിധാഥരീ	ویدهاتهری
വിന്ധുജാ	ویندهوجا
വിബാലീ	ویبالی
വിഭാവാ	ویبهاوا
വിഭൂതി	ویبهوتی
വിഭൂഷ	ویبهوش
വിയാമര്ശ	وییامرش
വിരഗനാപതീ	ویرجنابتی
വിരഭാദ്രപ്പാ	ویربهادرببا
വിരാജ	ویراج
വിലാശീനീ	ویلاشینی
വീണാ	وینا
വീണാധാരീ	وینادهاری
വേക്രാംത	ویكرانت
വേഗ	ویج
വേഗവാഹീനീ	ویجواهینی
വേഗീ	ویجی
വേണു	وینو
വേത്ത്രീ	ویتتری
വേത്രിവാല	ویتریوال
വേത്രീവേല	ویتریویل
വേദകാര്തിക	ویدكارتیك
വേദവല്ലീ	ویدوللی
വേദാ	ویدا
വേദാ ശ്രീ	ویدا شری
വേധാംത	ویدهانت
വേന്കാത്രമണ	وینكاترمن
വേന്തന	وینتن
വേന്നേലാ	ویننیلا
വേന്മതീ	وینمتی
വേലു	ویلو
വേഹംത	ویهنت
വൈകുംഠ	وایكونطه
വൈജീനാഥ	وایجیناته
വൈദത	وایدت
വൈദേഹീ	وایدیهی
വൈദ്യുംത	وایدیونت
വൈധേ	وایدهي
വൈധ്യാത	وایدهیات
വൈരാഗ	وایراج
വൈരോചന	وایریاتشن
വൈശാലീ	وایشالی
വൈശ്വീ	وایشوی
വൈഷ്ണവീ	وایشنوی
വൈസകാ	وایسكا
സംക്രാംതി	سنكرانتی
സംഗമിത്ര	سنجمیتر
സംഗമീധീരാ	سنجمیدهیرا
സംചയ	سنتشی
സംചീതീ	سنتشیتی
സംജേനാ	سنجینا
സംജോലീ	سنجیالی
സംതോക	سنتیاك
സംദിപോന	سندیبیان
സംദീപ	سندیب
സംദേശ	سندیش
സംധരാ	سندهرا
സംധ്യാ	سندهیا
സംബീതാ	سنبیتا
സംമീതാ	سنمیتا
സംയുക്ത	سنیوكت
സംവിധാ	سنویدها
സംവീഥാ	سنویتها
സംസ്കൃതി	سنسكرتی
സംഹിത	سنهیت
സക്ശീന്യാ	سكشینیا
സഖ്യാ	سكهیا
സഗന	سجن
സഗുനാ	سجونا
സചിതാ	ستشیتا
സചിദാനംദ വിഗ്രഹ	ستشیدانند ویجره
സചേതന	ستشیتن
സച്ചിദാനംദാ	ستشتشیدانندا
സജീത	سجیت
സജീലീ	سجیلی
സദഗതി	سدجتی
സദഗുനാ	سدجونا
സദാശിവ	سداشیو
സദിശ	سدیش
സപനാ	سبنا
സപുഷ്പാ	سبوشبا
സപ്താബീ	سبتابی
സപ്തോര്ശീ	سبتیارشی
സമജാ	سمجا
സമദര്ശീ	سمدرشی
സമഭ്ദ്ധാ	سمبهددها
സമരേശ	سمریش
സമാംദ്രിതാ	سماندریتا
സമാംര്ധ	سمانرده
സമാജസ	سماجس
സമാരാസ്യാ	سماراسیا
സമിക	سمیك
സമിരന	سمیرن
സമേംദ്ര	سمیندر
സമേശ	سمیش
സമ്പൂര്ണ	سمبورن
സമ്പ്രഥ്യ	سمبرتهی
സമ്പ്രീതീ	سمبریتی
സമ്രാട	سمراط
സമ്രീധ	سمریده
സരസംഗീ	سرسنجی
സലീജ	سلیج
സഹര്സീതാ	سهرسیتا
സഹശ്രദ	سهشرد
സഹസ്ത്രജീത	سهسترجیت
സഹസ്ത്രബാഹു	سهسترباهو
സഹീത	سهیت
സഹീരാമ	سهیرام
സഹ്യ	سهی
സാംജ	سانج
സാഇ രാമ	ساي رام
സാഈനാഥ	سايناته
സാചീ	ساتشی
സാജന	ساجن
സാദ്രീശീ	سادریشی
സാദ്വിഥാ	سادویتها
സാധന	سادهن
സാധ്യാ	سادهیا
സാനിധ്യ	سانیدهی
സാമംതാ	سامنتا
സാമ്ഭാ	سامبها
സാരണീ	سارنی
സാരഥീ	سارتهی
സാരികാ	ساریكا
സാലവീ	سالوی
സാലസാ	سالسا
സൈകത	سایكت
സൈനീത്യ	ساینیتی
സൈന്ധന്യ	سایندهنی
സൈലീ	سایلی
സൈഹാര്സന	سایهارسن
ഹംസമാലാ	هنسمالا
ഹംസാവാഥ്യ	هنساواتهی
ഹനാര്വീന	هناروین
ഹനീതാ	هنیتا
ഹനുപ	هنوب
ഹനുമാന	هنومان
ഹബീതാ	هبیتا
ഹമസാദീപികാ	همسادیبیكا
ഹമസാനംദീനീ	همسانندینی
ഹമീര	همیر
ഹരജീത	هرجیت
ഹരജീവന	هرجیون
ഹരനാധ	هرناده
ഹരശും	هرشون
ഹരികിശന	هریكیشن
ഹരിഗംഗാ	هریجنجا
ഹരിഗോപാല	هریجیابال
ഹരിദാസ	هریداس
ഹരിദ്വാര	هریدوار
ഹരിപ്രീത	هریبریت
ഹരിമംതീ	هریمنتی
ഹരീ	هری
ഹരേശ്വര	هریشور
ഹര്മീന	هرمین
ഹര്ഷണ	هرشن
ഹര്സികാ	هرسیكا
ഹശ്മീതാ	هشمیتا
ഹസമുഖ	هسموكه
ഹസീതാ	هسیتا
ഹസ്വീഥാ	هسویتها
ഹാര്ദീനീ	هاردینی
ഹാര്ശീനീ	هارشینی
ഹാലിക	هالیك
ഹിംഡോള	هیندیار
ഹിംദോലാ	هیندیالا
ഹിതാക്ഷീ	هیتاكشی
ഹിതീ	هیتی
ഹിഥീക്സാ	هیتهیكسا
ഹിമാംശു	هیمانشو
ഹിമാക്ഷ	هیماكش
ഹിമാലയ	هیمالی
ഹിരംയക	هیرنیك
ഹിരവ	هیرو
ഹിരവാ	هیروا
ഹിരുധായാ	هیرودهایا
ഹിവാ	هیوا
ഹീരാനമാം	هیرانمان
ഹീരാന്യാപ്രകാഈ	هیرانیابركاي
ഹീര്നാക്ഷീ	هیرناكشی
ഹുവീശ്കാ	هوویشكا
ഹൃദയനാഥ	هردیناته
ഹേഈദീ	هیيدی
ഹേജല	هیجل
ഹേതാ	هیتا
ഹേതാശ	هیتاش
ഹേത്ശ്രീ	هیتشری
ഹേഥാന്ശ്രീ	هیتهانشری
ഹേനീത	هینیت
ഹേനീല	هینیل
ഹേമനാഥ	هیمناته
ഹേമലതാ	هیملتا
ഹേമാ	هیما
ഹേമാംദ്രികാ	هیماندریكا
ഹേമാഗൌരീ	هیماجیری
ഹേമാനംദ	هیمانند
ഹേമാലാ	هیمالا
ഹേമാവതീ	هیماوتی
ഹേമാവാതിനംദന	هیماواتینندن
ഹേമേംദു	هیمیندو
ഹേയന	هیین
ഹേയാംശ	هییانش
ഹേരീത	هیریت
ഹേലീ	هیلی
ഹോന്നേശാ	هیاننیشا
ഹോമാ	هیاما
ഹ്രീത്വിക	هریتویك
ഹ്രീദാന്ക്ഷ	هریدانكش
ഹ്രീധാന	هریدهان
ഹ്രീശന	هریشن
ഹ്രീശാംത	هریشانت
ഹ്രീഷിത	هریشیت
ഹ്രുദയ	هرودی
ഹ്രുശാല	هروشال
ഹ്രേയാംശ	هرییانش
ഹ്ര്യ്ദയേശ	هریدییش
