# Baby names
ਅਂਗਦ	انجد
ਅਂਗਦ ਦੇਵ	انجد دیو
ਅਂਗਾਰਿਕਾ	انجاریكا
ਅਂਤਰਜੋਤ	انترجوت
ਅਂਤਰਪ੍ਰਿਤ	انتربریت
ਅਂਤਰਾ	انترا
ਅਕਲਤਟ	اكلتط
ਅਕਲਰੂਪ	اكلروب
ਅਕਲਸ਼ਰਣ	اكلسرن
ਅਕਲਸੀਮਾਰ	اكلسیمار
ਅਕਾਲਜੋਗ	اكالجوج
ਅਕਾਲਦੀਪ	اكالدیب
ਅਕਾਲਪ੍ਰੀਤ	اكالبریت
ਅਕਾਲਬੀਰ	اكالبیر
ਅਗਮਜੀਤ	اجمجیت
ਅਗਮਜੋਤ	اجمجوت
ਅਗਮ੍ਪਾਲ	اجمبال
ਅਗਮ੍ਪ੍ਰੀਤ	اجمبریت
ਅਜ੍ਮੀਨ੍ਦੇਰ	اجمیندیر
ਅਝਾਦਬੀਰ	اجهادبیر
ਅਝੀਝ	اجهیجه
ਅਤੀਨਦੇਰ੍ਜਿਤ	اتیندیرجیت
ਅਤੀਨ੍ਦੇਰ	اتیندیر
ਅਤ੍ਤਾਮਜਿਤ	اتتامجیت
ਅਨਂਤਦੇਵ	اننتدیو
ਅਨਂਤਰ	اننتر
ਅਨਂਤਵੀਰ	اننتویر
ਅਨਂਤ੍ਜੀਤ	اننتجیت
ਅਨਾਹਤ	اناهت
ਅਨਿਂਦਿਤਾ	انیندیتا
ਅਨਿਸ਼ਾ	انیسا
ਅਨੀਲਜੋਤ	انیلجوت
ਅਨੀਸ਼੍ਕੋਉਂਰ	انیسكوونر
ਅਨੁਂਜਪਾਲ	انونجبال
ਅਨੁਂਪਜੋਤ	انونبجوت
ਅਨੁਰਾਧਾ	انورادها
ਅਨੁਸ਼੍ਕਾ	انوسكا
ਅਨੂਪਜੋਤ	انوبجوت
ਅਨੂਪਬੀਰ	انوببیر
ਅਨੂਪਲੋਕ	انوبلوك
ਅਪੂਰ੍ਵਾ	ابوروا
ਅਪ੍ਰੀਨਦੇਰ	ابریندیر
ਅਬਨੀ	ابنی
ਅਬਿਚਾਲ	ابیتشال
ਅਬਿਨਾਸ਼	ابیناس
ਅਭਿਜੀਤ	ابهیجیت
ਅਭਿਰੂਪ	ابهیروب
ਅਮਨਜੀਤ	امنجیت
ਅਮਰਜੋਤ	امرجوت
ਅਮਰਤ	امرت
ਅਮਰਿਂਦਰ	امریندر
ਅਮਰਿਤ	امریت
ਅਮਲਜੋਤ	املجوت
ਅਮਾਨਜੀਵਨ	امانجیون
ਅਮਾਨੀਨ੍ਦੇਰ	امانیندیر
ਅਮਾਨ੍ਰੂਪ	امانروب
ਅਮਾਰ੍ਪਾਲ	اماربال
ਅਮਾਰ੍ਬੀਰ	اماربیر
ਅਮਿਕ	امیك
ਅਮਿਤ	امیت
ਅਮਿਤੋਜ	امیتوج
ਅਮੀਤਪਾਲ	امیتبال
ਅਮੀਤ੍ਬੀਰ	امیتبیر
ਅਮੋਲ੍ਰਸ	امولرس
ਅਮ੍ਨੀਨ੍ਦੇਰ	امنیندیر
ਅਮ੍ਰੀਤਬਾਨ	امریتبان
ਅਮ੍ਰੀਤ੍ਪ੍ਰਿਤ	امریتبریت
ਅਮ੍ਰੀਤ੍ਵਾਨੀ	امریتوانی
ਅਰਮਾਨੀ	ارمانی
ਅਰਵਜੋਤ	اروجوت
ਅਰੀਨਾਜੇਤ	اریناجیت
ਅਰੀਨ੍ਦੇਰ੍ਜੀਤ	اریندیرجیت
ਅਰੁਨਜੀਤ	ارونجیت
ਅਰੁਨਜੋਤ	ارونجوت
ਅਰ੍ਚਨਾ	ارتشنا
ਅਰ੍ਦਮਨ	اردمن
ਅਰ੍ਨਾਲੀਨ੍ਦੇਰ	ارنالیندیر
ਅਰ੍ਸ਼੍ਦੀਪ	ارسدیب
ਅਲੋਕ੍ਪਾਲ	الوكبال
ਅਲ੍ਪਨਾ	البنا
ਅਵਨੀਨਦੇਰ	اونیندیر
ਅਵਿਰ	اویر
ਅਵ੍ਲੀਨ	اولین
ਅਸਂਖ	اسنكه
ਅਸ਼ਮਿਤ	اسمیت
ਅਸ਼ਰ੍ਨਾਮ	اسرنام
ਅਸ਼ਰ੍ਪ੍ਰੀਤ	اسربریت
ਅਸ਼ਰ੍ਪ੍ਰੇਮ	اسربریم
ਅਸ਼ਰ੍ਵੀਰ	اسرویر
ਅਸ਼ਿਮਾ	اسیما
ਅਸੀਮ	اسیم
ਅਸੀਸ	اسیس
ਅਸ੍ਨੇਹ	اسنیه
ਆਖਰੀ	آكهری
ਆਤ੍ਮਜਾ	آتمجا
ਆਨਂਦਮਯੀ	آنندمیی
ਆਨਂਦਰੂਪ	آنندروب
ਆਯਕਾਰ	آیكار
ਆਯਾਤਪ੍ਰਿਤ	آیاتبریت
ਆਯੁਸ਼੍ਮਤਿ	آیوسمتی
ਆਰਮਾਨ	آرمان
ਆਰਾਧ	آراده
ਆਰਾਧਨਾ	آرادهنا
ਆਰ੍ਯਨ	آرین
ਇਂਦਰਬੀਰ	إندربیر
ਇਂਦਿਵਰ	إندیور
ਇਕਪ੍ਰਿਤ	إكبریت
ਇਕਬਾਲ	إكبال
ਇਕਰੂਪ	إكروب
ਇਕ੍ਪੂਜ	إكبوج
ਇਕ੍ਮਾਨ	إكمان
ਇਚ੍ਕਜਿਤ	إتشكجیت
ਇਨ੍ਦਾਰਤੇਜ	إندارتیج
ਇਨ੍ਦਾਰਮਿਤ	إندارمیت
ਇਨ੍ਦਾਰ੍ਦੀਪ	إنداردیب
ਇਨ੍ਦਾਰ੍ਪ੍ਰਿਤ	إنداربریت
ਇਨ੍ਦਾਰ੍ਪ੍ਰੇਮ	إنداربریم
ਇਨ੍ਦੇਰ	إندیر
ਇਨ੍ਦੇਰਪਲ	إندیربل
ਇਨ੍ਦੇਰਮਾਨ	إندیرمان
ਇਨ੍ਦੇਰਹਾਰ੍ਜਿਤ	إندیرهارجیت
ਇਮਰਾਤ	إمرات
ਈਖ੍ਤਿਅਰ	إكهتیار
ਈਨ੍ਦਰ੍ਜੀਏਤ	إندرجییت
ਈਨ੍ਦੇਰਤੇਕ	إندیرتیك
ਈਨ੍ਦੇਰਵੀਰ	إندیرویر
ਈਬਾਦਤ	إبادت
ਈਸ਼ਪਾਲ	إسبال
ਈਸ਼ਲੀਨ	إسلین
ਈਸ਼ਾਰਤੇਕ	إسارتیك
ਈਸ਼ਾਰਪਾਲ	إساربال
ਈਸ਼੍ਤ੍ਵਰ੍ਜਿਤ	إستورجیت
ਈਸ਼੍ਪ੍ਰਿਤ	إسبریت
ਈਸ਼੍ਵਾਰ੍ਜਿਤ	إسوارجیت
ਈਸ਼੍ਵੀਨਦੇਰ	إسویندیر
ਉਖ੍ਤਿਅਰ	وكهتیار
ਉਚਪਾਲ	وتشبال
ਉਚਪ੍ਰਿਤ	وتشبریت
ਉਚੀਤਦੀਪ	وتشیتدیب
ਉਚੀਤਪ੍ਰਿਤ	وتشیتبریت
ਉਚੀਤਬੀਰ	وتشیتبیر
ਉਚੀਤਰੂਪ	وتشیتروب
ਉਚੀਤਲੋਕ	وتشیتلوك
ਉਚੀਤਵਂਤ	وتشیتونت
ਉਜਗਰ੍ਜੋਤ	وججرجوت
ਉਜਗਰ੍ਦੀਪ	وججردیب
ਉਜਗਰ੍ਬੀਰ	وججربیر
ਉਜਾਗਰ	وجاجر
ਉਜਾਲਾ	وجالا
ਉਜ੍ਜਲਜੋਤ	وججلجوت
ਉਤ੍ਤਮ	وتتم
ਉਤ੍ਤਮਪਾਲ	وتتمبال
ਉਤ੍ਤਮਲੀਵ	وتتملیو
ਉਤ੍ਤਾਮਕਾਰਾਮ	وتتامكارام
ਉਤ੍ਤਾਮਜੋਧ	وتتامجوده
ਉਤ੍ਤਾਮਤਿਰਥ	وتتامتیرته
ਉਤ੍ਤਾਮਤੇਕ	وتتامتیك
ਉਤ੍ਤਾਮਦੀਪ	وتتامدیب
ਉਤ੍ਤਾਮਪਦ	وتتامبد
ਉਤ੍ਤਾਮ੍ਰਸ	وتتامرس
ਉਤ੍ਤਾਮ੍ਰੂਪ	وتتامروب
ਉਤ੍ਰਕ੍ਸ਼	وتركس
ਉਦੀਤਦੀਪ	ودیتدیب
ਉਦੀਤਪ੍ਰਿਤ	ودیتبریت
ਉਦੀਤਬੀਰ	ودیتبیر
ਉਦੈਬੀਰ	ودایبیر
ਉਦੈਭਗਤ	ودایبهجت
ਉਦ੍ਦਾਮਜੀਤ	وددامجیت
ਉਪਕਰਮ	وبكرم
ਉਪਕਿਰਤ	وبكیرت
ਉਪਜਿਤ	وبجیت
ਉਪਨਿਤ	وبنیت
ਉਪੀਨਦੇਰ੍ਪ੍ਰਿਤ	وبیندیربریت
ਉਪੇਨ੍ਦੇਰ	وبیندیر
ਉਮੀਦ	ومید
ਊਤ੍ਤਮ੍ਗਿਆਨ	وتتمجیآن
ਏਕਂਕਰ	یكنكر
ਏਕਬੀਰ	یكبیر
ਏਕਮ	یكم
ਏਕਮਪੂਜ	یكمبوج
ਏਕਮਬੀਰ	یكمبیر
ਏਕਮ੍ਜੋਤ	یكمجوت
ਏਕਮ੍ਰੂਪ	یكمروب
ਏਕਾਨਪ੍ਰੀਤ	یكانبریت
ਏਕ੍ਕਾਮ	یككام
ਏਤੀਬਾਰ	یتیبار
ਏਤ੍ਤਲੀਨ	یتتلین
ਏਰਸ਼ੀਨ	یرسین
ਏਵੇਨਿਤ	یوینیت
ਏਸ਼ਨਾ	یسنا
ਏਸ਼੍ਵਰ	یسور
ਓਨਕਾਰ੍ਜਿਤ	اونكارجیت
ਓਨਕਾਰ੍ਜੀਤ	اونكارجیت
ਓਨਕਾਰ੍ਪ੍ਰਿਤ	اونكاربریت
ਓਮਪ੍ਰਿਤ	اومبریت
ਕਂਵਲ	كنول
ਕਂਵਲਜੀਤ	كنولجیت
ਕਨਵਾਰ੍ਜਾਗਤ	كنوارجاجت
ਕਨਵਾਰ੍ਜਿਤ	كنوارجیت
ਕਨਵਾਰ੍ਪ੍ਰੇਮ	كنواربریم
ਕਨਵਾਲ੍ਜੋਤ	كنوالجوت
ਕਨਵਾਲ੍ਨੈਨ	كنوالناین
ਕਨਵਾਲ੍ਪਾਲ	كنوالبال
ਕਨਵਾਲ੍ਪ੍ਰੇਮ	كنوالبریم
ਕਨਵਾਲ੍ਬੀਰ	كنوالبیر
ਕਨਵਾਲ੍ਰੂਪ	كنوالروب
ਕਨ੍ਚਨ੍ਦੀਪ	كنتشندیب
ਕਨ੍ਚਾਨ੍ਪਾਲ	كنتشانبال
ਕਨ੍ਵਾਰਪਾਲ	كنواربال
ਕਮਾਲ੍ਲਾ	كماللا
ਕਰਨਦੀਪ	كرندیب
ਕਰਨਪਾਲ	كرنبال
ਕਰਨਪ੍ਰਿਤ	كرنبریت
ਕਰਨਰੂਪ	كرنروب
ਕਰਮਪਲ	كرمبل
ਕਰਮਪੁਲ	كرمبول
ਕਰਮ੍ਜੋਤ	كرمجوت
ਕਰੁਨ੍ਯਾ	كرونیا
ਕਲਬੀਰ	كلبیر
ਕਲਾਜੋਤ	كلاجوت
ਕਲਾਪ੍ਰੇਮ	كلابریم
ਕਵਨਿਤ	كونیت
ਕਵਨੀਰ	كونیر
ਕਵਾਲ੍ਨਾਨ	كوالنان
ਕਵਿਰਾਜ	كویراج
ਕਸਮ	كسم
ਕਾਨਵਾਲੀਨ੍ਦੇਰ	كانوالیندیر
ਕਾਮਾਂਲਜੋਤ	كامانلجوت
ਕਾਮਾਂਲਮਿਤ	كامانلمیت
ਕਾਮਾਂਲਮੋਹਨ	كامانلموهن
ਕਾਮਾਂਲ੍ਪਤਿ	كامانلبتی
ਕਾਰਮਨ	كارمن
ਕਾਵਾਲਪ੍ਰਿਤ	كاوالبریت
ਕਿਰਣਜੀਤ	كیرنجیت
ਕਿਰਨਰੂਪ	كیرنروب
ਕਿਰਨਸੁਖ	كیرنسوكه
ਕਿਸ਼ੇਨ	كیسین
ਕੁਂਵਰਜੀਤ	كونورجیت
ਕੁਲ	كول
ਕੁਲਜੋਤ	كولجوت
ਕੁਲਮਿਤ	كولمیت
ਕੁਲਰਾਤਨ	كولراتن
ਕੁਲਰੂਪ	كولروب
ਕੁਲਵਂਠ	كولونطه
ਕੁਸ਼ਪ੍ਰਿਤ	كوسبریت
ਕੇਵਾਲਦੀਪ	كیوالدیب
ਕੇਵਾਲਬੀਰ	كیوالبیر
ਕੋਉਰ	كوور
ਕੋਮਾਂਲਜੀਤ	كومانلجیت
ਕੋਮਾਂਲਪ੍ਰੇਮ	كومانلبریم
ਕੋਮਾਲਦੀਪ	كومالدیب
ਕੋਮਾਲਮਿਤ	كومالمیت
ਕੌਰ	كاور
ਕ੍ਰਿਸ਼੍ਦੀਪ	كریسدیب
ਕ੍ਸ਼ਾਗਨ	كساجن
ਕ੍ਸ਼ਾਗਰ	كساجر
ਕ੍ਸ਼ਿਤਿਜ	كسیتیج
ਕ੍ਸ਼੍ਹੀਮ	كسهیم
ਖਰਗ	كهرج
ਖਾਲਾਕ੍ਵੀਰ	كهالاكویر
ਖੁਂਸ਼ਜੋਤ	كهونسجوت
ਖੁਸ	كهوس
ਖੁਸ਼	كهوس
ਖੁਸ਼ਜੀਤ	كهوسجیت
ਖੇਮਵਂਤ	كهیمونت
ਗਗਨ	ججن
ਗਗਨਜੀਵ	ججنجیو
ਗਗਨਜੋਤ	ججنجوت
ਗਗਨਪ੍ਰਿਤ	ججنبریت
ਗਗਨਮਿਤ	ججنمیت
ਗਤਲੀਨ	جتلین
ਗਤਸ਼ਰਣ	جتسرن
ਗਤਸੀਮਾਰ	جتسیمار
ਗਰੀਨ੍ਦੇਰ	جریندیر
ਗਰ੍ਗੋਤ	جرجوت
ਗਾਤਨੀਵਾਸ	جاتنیواس
ਗਿਅਨ	جیان
ਗੀਂਜੀਵਨ	جینجیون
ਗੀਂਰਾਤਨ	جینراتن
ਗੀਂਲੀਨ	جینلین
ਗੀਅਂਗੀਤ	جیانجیت
ਗੀਅਂਚੇਤਨ	جیانتشیتن
ਗੀਅਂਜੋਤ	جیانجوت
ਗੀਅਂਪ੍ਰਿਤ	جیانبریت
ਗੀਅਂਰੂਪ	جیانروب
ਗੀਅਨੀਨਦੇਰ	جیانیندیر
ਗੀਅਨ੍ਬੀਰ	جیانبیر
ਗੀਆਨਪ੍ਰਿਤ	جیآنبریت
ਗੀਆਨਲੀਨ	جیآنلین
ਗੀਤ	جیت
ਗੀਤਲੀਨ	جیتلین
ਗੀਤੀਨਦੇਰ	جیتیندیر
ਗੁਣਿਤ	جونیت
ਗੁਨ ਦਾਤ	جون دات
ਗੁਨਕਿਰਤ	جونكیرت
ਗੁਨਜਸ	جونجس
ਗੁਨਜਿਤ	جونجیت
ਗੁਨਜੀਵਨ	جونجیون
ਗੁਨਜੁਨ	جونجون
ਗੁਨਜੋਤ	جونجوت
ਗੁਨਪ੍ਰਿਤ	جونبریت
ਗੁਨਮਿਤ	جونمیت
ਗੁਨਰਾਜ	جونراج
ਗੁਨਸ਼ਾਂਤ	جونسانت
ਗੁਨਾਤਮ	جوناتم
ਗੁਨਿਤਪੁਲ	جونیتبول
ਗੁਨਿਤਪ੍ਰਿਤ	جونیتبریت
ਗੁਨ੍ਰਿਤ	جونریت
ਗੁਰਕਮਲ਼	جوركمل
ਗੁਰਗਿਯਨ	جورجیین
ਗੁਰਜਾਸ	جورجاس
ਗੁਰਜੀਵਨ	جورجیون
ਗੁਰਜੋਗ	جورجوج
ਗੁਰਜੋਤ	جورجوت
ਗੁਰਝੀਲ	جورجهیل
ਗੁਰਤਰਣ	جورترن
ਗੁਰਤਿਰਥ	جورتیرته
ਗੁਰਦਰ੍ਸ਼ਨ	جوردرسن
ਗੁਰਦਿਤ	جوردیت
ਗੁਰਦੀਤ੍ਤਾ	جوردیتتا
ਗੁਰਦ੍ਵੀਪ	جوردویب
ਗੁਰਨਾਦ	جورناد
ਗੁਰਨਾਮਾਸ੍ਕਾਰ	جورناماسكار
ਗੁਰਨੀਧ	جورنیده
ਗੁਰਨੀਰ੍ਮਾਲ	جورنیرمال
ਗੁਰਨੀਸ਼ਾਨ	جورنیسان
ਗੁਰਨ੍ਯਮ	جورنیم
ਗੁਰਪਰ੍ਵਿਨ	جوربروین
ਗੁਰਪੀਨਦੇਰ	جوربیندیر
ਗੁਰਪ੍ਰੀਤਮ	جوربریتم
ਗੁਰਬਕ੍ਸ਼	جوربكس
ਗੁਰਬਲੀਹਾਰ	جوربلیهار
ਗੁਰਬੀਨ੍ਦੇਰ	جوربیندیر
ਗੁਰਬੀਰ	جوربیر
ਗੁਰਭਜਨ	جوربهجن
ਗੁਰਭਾਗਤ	جوربهاجت
ਗੁਰਮਾਰ	جورمار
ਗੁਰਮਾਹੇਰ	جورماهیر
ਗੁਰਮੁਖ	جورموكه
ਗੁਰਮੇਹਾਰ	جورمیهار
ਗੁਰਮੈਲ	جورمایل
ਗੁਰਮ੍ਰਿਤ	جورمریت
ਗੁਰਲੋਚਨ	جورلوتشن
ਗੁਰਵਿਂਦਰ	جورویندر
ਗੁਰਵੀਨ੍ਦੇਰ	جورویندیر
ਗੁਰਵੀਰ	جورویر
ਗੁਰਸਨ੍ਦੀਪ	جورسندیب
ਗੁਰਸ਼ਾਨ	جورسان
ਗੁਰਸੁਖ	جورسوكه
ਗੁਰਸੇਵ	جورسیو
ਗੁਰਹਾਰ੍ਪਾਲ	جورهاربال
ਗੁਰਿਂਦਰ	جوریندر
ਗੁਰੀਨਦੇਰ੍ਪਾਲ	جوریندیربال
ਗੁਰੁਕਾਰ	جوروكار
ਗੁਰੁਗੁਲ੍ਝਾਰ	جوروجولجهار
ਗੁਰੁਚਰਣ	جوروتشرن
ਗੁਰੁਦਰ੍ਸ਼ਨ	جورودرسن
ਗੁਰੁਦਾਸ	جوروداس
ਗੁਰੁਦੀਪ	جورودیب
ਗੁਰੁਪ੍ਰੇਮ	جوروبریم
ਗੁਰੁਬੀਰ	جوروبیر
ਗੁਰੁਮਾਂਨ੍ਦੀਰ	جورومانندیر
ਗੁਰੁਸੀਮ੍ਰਣ	جوروسیمرن
ਗੁਰ੍ਕੀਰਣ	جوركیرن
ਗੁਰ੍ਕੀਰਪਾਲ	جوركیربال
ਗੁਰ੍ਚਾਰਾਨ੍ਜੋਤ	جورتشارانجوت
ਗੁਰ੍ਜਨਪਾਲ	جورجنبال
ਗੁਰ੍ਜੁ	جورجو
ਗੁਰ੍ਤੇਜ	جورتیج
ਗੁਰ੍ਨੀਵਾਝ	جورنیواجه
ਗੁਰ੍ਨੂਰ	جورنور
ਗੁਰ੍ਪ੍ਰਿਤੀ	جوربریتی
ਗੁਰ੍ਮੀਤ	جورمیت
ਗੁਰ੍ਮੀਨਦੇਰ	جورمیندیر
ਗੁਰ੍ਮੁਖਨੀਹਲ	جورموكهنیهل
ਗੁਰ੍ਸ਼ਣ	جورسن
ਗੁਰ੍ਸ਼ਾਂਤ	جورسانت
ਗੁਰ੍ਸ਼ੀਲ	جورسیل
ਗੁਰ੍ਸਾਹੇਬ	جورساهیب
ਗੁਲਦੀਪ	جولدیب
ਗੁਲਵਂਤ	جولونت
ਗੁਲਸ਼ਾਨ੍ਰੂਪ	جولسانروب
ਗੁਲ੍ਵਾਨ੍ਤਪ੍ਰਿਤ	جولوانتبریت
ਗੁਲ੍ਸ਼ਾਨਪ੍ਰਿਤ	جولسانبریت
ਗੁਲ੍ਸ਼ਾਨਮਿਤ	جولسانمیت
ਗੋਪਲਪ੍ਰਿਤ	جوبلبریت
ਗੋਬਿਂਦ	جوبیند
ਗੋਬੀਨਦੇਰ	جوبیندیر
ਗੋਬੀਨਦੇਰ੍ਜਿਤ	جوبیندیرجیت
ਗੋਬੀਨ੍ਦਰਾਈ	جوبیندراإ
ਗੌਰਵ੍ਪ੍ਰਿਤ	جاوروبریت
ਘਮਾਂਨਦ੍ਜਿਤ	جهمانندجیت
ਘਮਾਂਨਦ੍ਪਾਲ	جهمانندبال
ਚਂਚਲਜਿਤ	تشنتشلجیت
ਚਂਚਲ੍ਪ੍ਰੀਤ	تشنتشلبریت
ਚਂਦਨ	تشندن
ਚਂਦਨਦੀਪ	تشندندیب
ਚਮਕੌਰ	تشمكاور
ਚਮਨਜਿਤ	تشمنجیت
ਚਮਨਪ੍ਰਿਤ	تشمنبریت
ਚਮਨਰੂਪ	تشمنروب
ਚਰਨਕਾਨ੍ਵਾਲ	تشرنكانوال
ਚਰਨਜੋਤ /ਚਰਨਜ੍ਯੋਤ	تشرنجوت /تشرنجیوت
ਚਰਨਪ੍ਰੇਮ	تشرنبریم
ਚਾਂਦ	تشاند
ਚਿਤਰਾਮਣ	تشیترامن
ਚਿਤਸਰੂਪ	تشیتسروب
ਚੀਤਪ੍ਰਿਤ	تشیتبریت
ਚੇਤਨ੍ਦੀਪ	تشیتندیب
ਜਗਜੀਤ	جججیت
ਜਗਜੀਵ	جججیو
ਜਗਜੀਵਨ	جججیون
ਜਗਤਜੀਤ	ججتجیت
ਜਗਤਪ੍ਰੇਮ	ججتبریم
ਜਗਤਰਣ	ججترن
ਜਗਤਰੂਪ	ججتروب
ਜਗਨ	ججن
ਜਗਪਾਲ	ججبال
ਜਗਪ੍ਰਿਤ	ججبریت
ਜਗਪ੍ਰੇਮ	ججبریم
ਜਗਮਿਤ	ججمیت
ਜਗਮੇਹਾਰ	ججمیهار
ਜਗਮੋਹਨ	ججموهن
ਜਗਰਾਜ	ججراج
ਜਗਰੂਪ	ججروب
ਜਗਵੀਨ੍ਦੇਰ	ججویندیر
ਜਗਵੀਰ	ججویر
ਜਗੀਨਦੇਰ	ججیندیر
ਜਗੀਨ੍ਦੇਰਪਾਲ	ججیندیربال
ਜਗ੍ਵੀਰ	ججویر
ਜਘ੍ਰ	ججهر
ਜਤੀਨਦੇਰ੍ਜਿਤ	جتیندیرجیت
ਜਤੀਨਦੇਰ੍ਬੀਰ	جتیندیربیر
ਜਤੀਨਦੇਰ੍ਮਿਤ	جتیندیرمیت
ਜਨਜਿਤ	جنجیت
ਜਨਜੋਤ	جنجوت
ਜਨਪ੍ਰਿਤ	جنبریت
ਜਨਰਾਜ	جنراج
ਜਨਿਸ਼	جنیس
ਜਪਜਿਤ	جبجیت
ਜਪਧਾਰਾਮ	جبدهارام
ਜਪਧਿਰ	جبدهیر
ਜਪਨਾਮ	جبنام
ਜਪਸ਼ੇਰ	جبسیر
ਜਪੁਜੀ	جبوجی
ਜਬਰਜਂਗ	جبرجنج
ਜਮੀਲ	جمیل
ਜਯਂਸ਼	جینس
ਜਯਪਾਲ	جیبال
ਜਰ੍ਨੈਲ	جرنایل
ਜਲਿਨ੍ਦ੍ਰ	جلیندر
ਜਲ੍ਬੀਰ	جلبیر
ਜਸਂਜੋਤ	جسنجوت
ਜਸਂਪਾਲ	جسنبال
ਜਸਂਮਿਤ	جسنمیت
ਜਸਕੀਰਣ	جسكیرن
ਜਸਗੁਰ੍ਕੀਰ੍ਤਤ	جسجوركیرتت
ਜਸਜੀਨ੍ਦੇਰ	جسجیندیر
ਜਸਜੀਵਨ	جسجیون
ਜਸਜੋਤ	جسجوت
ਜਸਤਰਣ	جسترن
ਜਸਨਾਮ	جسنام
ਜਸਪਾਲ (ਪੁਲ )	جسبال (بول )
ਜਸਬੀਰ	جسبیر
ਜਸਭੂਪ	جسبهوب
ਜਸਮਿਂਦਰ	جسمیندر
ਜਸਮੋਹਨ	جسموهن
ਜਸਰੂਪ	جسروب
ਜਸ੍ਕਰਣ	جسكرن
ਜਸ੍ਕੀਰਿਤ	جسكیریت
ਜਸ੍ਕੀਰ੍ਪਲ	جسكیربل
ਜਸ੍ਗੁਨ	جسجون
ਜਸ੍ਮਿਤ	جسمیت
ਜਸ੍ਮੀਨਪ੍ਰਿਤ	جسمینبریت
ਜਸ੍ਰਜਪ੍ਰਿਤ	جسرجبریت
ਜਸ੍ਸੀ	جسسی
ਜਾਗ	جاج
ਜਾਗਰੀਤ	جاجریت
ਜਾਤਵਂਤ	جاتونت
ਜਾਤਿਨਦੇਰ੍ਦੀਪ	جاتیندیردیب
ਜਾਨਾਕਪ੍ਰਿਤ	جاناكبریت
ਜਾਪਮਾਨ	جابمان
ਜਾਸਨਿਤ	جاسنیت
ਜਾਸ਼ਾਨਪ੍ਰਿਤ	جاسانبریت
ਜਾਸ੍ਮੀਲ	جاسمیل
ਜੀਵਨਦੀਪ ; ਜੀਵਨਦੀਪ ; ਜੀਵਨਦੀਪ	جیوندیب ; جیوندیب ; جیوندیب
ਜੀਵਨਪਲ	جیونبل
ਜੀਵਨਪ੍ਰਿਤ	جیونبریت
ਜੀਵਾਨਬੀਰ	جیوانبیر
ਜੁਗਦ	جوجد
ਜੁਪੀਨਦੇਰਦੀਪ	جوبیندیردیب
ਜੁਪੀਨਦੇਰ੍ਬੀਰ	جوبیندیربیر
ਜੁਸਜਿਤ	جوسجیت
ਜੁਸਪੁਲ	جوسبول
ਜੁਸਮੈਲ	جوسمایل
ਜੇਬਾ	جیبا
ਜੇਸਪਾਲ	جیسبال
ਜੈਕਾਰ	جایكار
ਜੈਪ੍ਰਜ	جایبرج
ਜੈਪ੍ਰਤਨ	جایبرتن
ਜੈਬੀਰ	جایبیر
ਜੈਸਂਗਤ	جایسنجت
ਜੈਸੁਖਬੀਰ	جایسوكهبیر
ਜੋਗਧੀਆਨ	جوجدهیآن
ਜੋਗਪ੍ਰਕਾਸ਼	جوجبركاس
ਜੋਗੀਨਦੇਰ੍ਬੀਰ	جوجیندیربیر
ਜੋਗੀਨਦੇਰ੍ਮਿਤ	جوجیندیرمیت
ਜੋਗੇਨਦੇਰ	جوجیندیر
ਜੋਤਪ੍ਰਕਾਸ਼	جوتبركاس
ਜੋਬਨਰੂਪ	جوبنروب
ਜੋਹਾਰ	جوهار
ਜ੍ਞਾਨਜਿਤ	جنانجیت
ਜ੍ਞਾਨਜੋਤ	جنانجوت
ਜ੍ਞਾਨਪ੍ਰਿਤ	جنانبریت
ਜ੍ਞਾਨਰੂਪ	جنانروب
ਜ੍ਞਾਨਵੀਰ	جنانویر
ਜ੍ਞਾਨੇਨ੍ਦੇਰ	جنانیندیر
ਜ੍ਹਮਕ	جهمك
ਜ੍ਹਾਗਰ	جهاجر
ਝਈਤੂਨ	جهإتون
ਝਹਾਗਨ	جههاجن
ਝਾਮੀਨਾਹ	جهامیناه
ਝੀਤੁਨ	جهیتون
ਝੀਲ	جهیل
ਝੁਲਾਖਾ	جهولاكها
ਝੁਲ੍ਫਾ	جهولبها
ਝੇਬਵਂਤ	جهیبونت
ਝੋਰਾਵਾਰ	جهوراوار
ਟੇਇਜਿਨ੍ਦੇਰ	طیإجیندیر
ਤਕਦੀਰ	تكدیر
ਤਖਤ	تكهت
ਤਤਜੋਗ	تتجوج
ਤਤਬੀਰ	تتبیر
ਤਤਵਿਚਾਰ	تتویتشار
ਤਤ੍ਰਾਤਨ	تتراتن
ਤਦਬੀਰ	تدبیر
ਤਨਦੀਪ	تندیب
ਤਨਵੀਰ	تنویر
ਤਮਨ੍ਪ੍ਰਿਤ	تمنبریت
ਤਰਣਵੀਰ	ترنویر
ਤਰਲੋਚਨ	ترلوتشن
ਤਰਸੇਮ	ترسیم
ਤਰੁਨਜਿਤ	ترونجیت
ਤਲਵਿਨ	تلوین
ਤਾਜਦਾਰ	تاجدار
ਤਾਜੀਨਦੇਰ੍ਦੀਪ	تاجیندیردیب
ਤਾਜੀਨਦੇਰ੍ਪ੍ਰੇਮ	تاجیندیربریم
ਤਾਨੁਪ੍ਰਿਤ	تانوبریت
ਤਾਪਨਪਾਲ	تابنبال
ਤੀਰਨ /ਤਿਹ੍ਰਣ /ਤੇਯ੍ਰੁਣ	تیرن /تیهرن /تییرون
ਤੀਰਾਥ੍ਰਾਮ	تیراتهرام
ਤੁਵਿਜਾਤ	توویجات
ਤੇਕਜੀਤ	تیكجیت
ਤੇਕਦੀਪ	تیكدیب
ਤੇਕਪ੍ਰਿਤ	تیكبریت
ਤੇਕ੍ਪਾਲ	تیكبال
ਤੇਘਬਹਾਦੁਰ	تیجهبهادور
ਤੇਜਧਾਰਾਮ	تیجدهارام
ਤੇਜਨਾਮ	تیجنام
ਤੇਜਪ੍ਰਤਾਪ	تیجبرتاب
ਤੇਜ਼	تیج
ਤੇਜਾਸਵੀਰ	تیجاسویر
ਤੇਜੀਨਦੇਰ੍ਜੀਤ	تیجیندیرجیت
ਤੇਜੀਨਦੇਰ੍ਪਾਲ	تیجیندیربال
ਤੋਤਾਸਿਂਹ	توتاسینه
ਤ੍ਰਿਪਲ	تریبل
ਤ੍ਰਿਲੋਚਨ	تریلوتشن
ਤ੍ਰੀਭਾਵਾਨ	تریبهاوان
ਤ੍ਰੀਸ਼ਾਨਜੋਤ	تریسانجوت
ਤ੍ਰੀਸ਼ਾਨਦੀਪ	تریساندیب
ਤ੍ਰੀਸ਼ਾਨਬੀਰ	تریسانبیر
ਥਾਕੁਰਨਾਮ	تهاكورنام
ਥਾਲਭੂਪ	تهالبهوب
ਥਾਲਰਾਜ	تهالراج
ਥੀਰਮਾਨ	تهیرمان
ਥੀਰ੍ਧੀਆਨ	تهیردهیآن
ਦਮਨਜਿਤ	دمنجیت
ਦਮਨਜੋਤ	دمنجوت
ਦਯਾਜੋਤ	دیاجوت
ਦਯਾਦੀਪ	دیادیب
ਦਰਮੀਨ੍ਦੇਰ	درمیندیر
ਦਰ੍ਪ੍ਰਿਤ	دربریت
ਦਲਜੋਧ	دلجوده
ਦਲਬੀਨਦੇਰ	دلبیندیر
ਦਲਬੀਨ੍ਦੇਰ੍ਜਿਤ	دلبیندیرجیت
ਦਲਰਾਜ	دلراج
ਦਲੇਰ	دلیر
ਦਵੀਨ੍ਦੇਰ	دویندیر
ਦਿਦਾਰ	دیدار
ਦਿਨਤੇਕ	دینتیك
ਦਿਪਲੀਨ	دیبلین
ਦਿਲਜੋਤ	دیلجوت
ਦਿਲਨਿਤ	دیلنیت
ਦਿਲਪ੍ਰਿਤ	دیلبریت
ਦਿਲਮਿਤ	دیلمیت
ਦਿਲਰਿਤ	دیلریت
ਦਿਲਸ਼ਾਨ	دیلسان
ਦਿਲਸ਼ੇਰ	دیلسیر
ਦਿਵ੍ਯਜ੍ਯੋਤ	دیویجیوت
ਦੀਲਜੀਤ	دیلجیت
ਦੀਲਬਾਘ	دیلباجه
ਦੀਲ੍ਜਿਤ	دیلجیت
ਦੀਵ੍ਯਜੋਤ	دیویجوت
ਦੇਵਜੀਤ	دیوجیت
ਦੇਵਪ੍ਰਿਤ	دیوبریت
ਦੇਵਾਤ੍ਮਾ	دیواتما
ਦੇਵੀਨ੍ਦੇਰ	دیویندیر
ਧਰਮਜ੍ਯੋਤ	دهرمجیوت
ਧਰਮਪਾਲ	دهرمبال
ਧਰਮਪ੍ਰੀਤ	دهرمبریت
ਧਰਮਲੀਨ	دهرملین
ਧੀਅਨ੍ਜੋਗ	دهیانجوج
ਨਕ੍ਸ਼ਤ੍ਰਾ	نكسترا
ਨਮ੍ਰੀਤਾਬੀਰ	نمریتابیر
ਨਯਨਦੀਪ	نیندیب
ਨਰਿਨ੍ਦਰ	نریندر
ਨਰੇਨ੍ਦ੍ਰ	نریندر
ਨਵਜੀਤ	نوجیت
ਨਵਜੀਵਨ	نوجیون
ਨਵਦੀਪ	نودیب
ਨਵਬੀਰ	نوبیر
ਨਵਮਿਤ	نومیت
ਨਵ੍ਜੀਨ੍ਦੇਰ	نوجیندیر
ਨਾਗਂਦਰ	ناجندر
ਨਾਨਕੀ	نانكی
ਨਾਨਵੀਰ	نانویر
ਨਾਨ੍ਦਾਨਜਿਤ	ناندانجیت
ਨਾਨ੍ਦਾਨਪ੍ਰਿਤ	ناندانبریت
ਨਾਮਜੀਵ	نامجیو
ਨਾਮਜੋਗ	نامجوج
ਨਾਮਜੋਤ	نامجوت
ਨਾਮਜੋਧ	نامجوده
ਨਾਮਧਾਰ	نامدهار
ਨਾਮਧਿਯਨ	نامدهیین
ਨਾਮਧਿਰ	نامدهیر
ਨਾਮਨੀਰ੍ਮਾਲ	نامنیرمال
ਨਾਮਨੀਵਾਸ	نامنیواس
ਨਾਮਪ੍ਰਿਤ	نامبریت
ਨਾਮਪ੍ਰੇਮ	نامبریم
ਨਾਮਭਾਗਤ	نامبهاجت
ਨਾਮਵਿਚਾਰ	نامویتشار
ਨਾਮਸ਼ਰਣ	نامسرن
ਨਾਮਾਂਡੋਲ਼	ناماندول
ਨਾਮਾਹਾਰ	ناماهار
ਨਾਮੁਤ੍ਤਮ	ناموتتم
ਨਾਮ੍ਰਾਤਨ	نامراتن
ਨਾਮ੍ਰਿਤਾ	نامریتا
ਨਾਮ੍ਰੀਤਾਜੋਤ	نامریتاجوت
ਨਾਮ੍ਰੀਤਾਦੀਪ	نامریتادیب
ਨਾਮ੍ਰੀਤਾਪ੍ਰਿਤ	نامریتابریت
ਨਾਰ	نار
ਨਾਰਂਜਨ	نارنجن
ਨਾਰੀਤਪਲ	ناریتبل
ਨਾਰੀਨਦੇਰਦੀਪ	ناریندیردیب
ਨਾਰੈਨ	ناراین
ਨਾਵਿਨਜਿਤ	ناوینجیت
ਨਾਵ੍ਕੀਰਣ	ناوكیرن
ਨਾਵ੍ਕੀਰਨਜੋਤ	ناوكیرنجوت
ਨਾਵ੍ਪ੍ਰਿਤ	ناوبریت
ਨਿਮਾਈ	نیماإ
ਨਿਰਂਜਨ	نیرنجن
ਨਿਰਂਜਨਾ	نیرنجنا
ਨਿਰ੍ਮਲਜੀਤ	نیرملجیت
ਨਿਲਾਮਜੋਤ	نیلامجوت
ਨਿਲਾਮਪੁਲ	نیلامبول
ਨਿਲਾਮਪ੍ਰਿਤ	نیلامبریت
ਨਿਲਾਮਬੇਰ	نیلامبیر
ਨਿਸ਼ਾ	نیسا
ਨਿਹ੍ਚਾਲਤੇਕ	نیهتشالتیك
ਨਿਹ੍ਚਾਲਮਿਤ	نیهتشالمیت
ਨੀਤਨਾਮ	نیتنام
ਨੀਨਦੇਰ੍ਬੀਰ	نیندیربیر
ਨੀਮਮਾਂਪ੍ਰਿਤ	نیممانبریت
ਨੀਮਮਾਂਰ੍ਦੀਪ	نیممانردیب
ਨੀਮ੍ਮਾਂਰਤਾ	نیممانرتا
ਨੀਮ੍ਰਤ	نیمرت
ਨੀਰਮਾਂਲਦੀਪ	نیرمانلدیب
ਨੀਰਮਾਂਲਬੀਰ	نیرمانلبیر
ਨੀਰਮੋਲ	نیرمول
ਨੀਰਵੈਰ	نیروایر
ਨੀਰ੍ਭਾਉ	نیربهاو
ਨੀਰ੍ਮਾਂਲਕਾਰਾਮ	نیرمانلكارام
ਨੀਰ੍ਮਾਂਲਜੀਵ	نیرمانلجیو
ਨੀਰ੍ਮਾਂਲਜੋਤ	نیرمانلجوت
ਨੀਰ੍ਮਾਂਲਤੇਕ	نیرمانلتیك
ਨੀਰ੍ਮਾਂਲਧਾਰਾਮ	نیرمانلدهارام
ਨੀਰ੍ਮਾਂਲਪ੍ਰਿਤ	نیرمانلبریت
ਨੀਸ਼ਾਨ੍ਦੀਪ	نیساندیب
ਨੀਹ੍ਚਾਲ੍ਪ੍ਰੇਮ	نیهتشالبریم
ਨੂਰਦੇਵ	نوردیو
ਨੂਰਨਿਤ	نورنیت
ਨੂਰਪ੍ਰਿਤ	نوربریت
ਨੇਕਨਾਮ	نیكنام
ਨੇਕੀਨਦੇਰ	نیكیندیر
ਨੇਕ੍ਦੀਪ	نیكدیب
ਨੇਕ੍ਪਾਲ	نیكبال
ਨੇਹ੍ਚਾਲਪ੍ਰਿਤ	نیهتشالبریت
ਨੈਨਤਾਰ	ناینتار
ਨੈਨਦੀਪ	نایندیب
ਨੈਨੀਨਦੇਰ	ناینیندیر
ਨੋਉਲਖ	نوولكه
ਨੌਹਨੀਹਲ	ناوهنیهل
ਨ੍ਰੀਪਜੋਤ	نریبجوت
ਪਤਵਂਤ	بتونت
ਪਤਵੀਰ	بتویر
ਪਦਾਮਜਿਤ	بدامجیت
ਪਦਾਮਪ੍ਰੇਮ	بدامبریم
ਪਦ੍ਮਸ਼੍ਰੀ	بدمسری
ਪਰਤਾਪ ; ਪਰਤਾਪ	برتاب ; برتاب
ਪਰਤਾਪੀ	برتابی
ਪਰਦੀਪ	بردیب
ਪਰਬੀਨ	بربین
ਪਰਮਕਮਲ਼	برمكمل
ਪਰਮਕਿਰਤ	برمكیرت
ਪਰਮਗੁਨ	برمجون
ਪਰਮਜਾਪ	برمجاب
ਪਰਮਜੀਤ ; ਪਰਮਜੀਤ	برمجیت ; برمجیت
ਪਰਮਜੁਗਤ	برمجوجت
ਪਰਮਜੋਗ	برمجوج
ਪਰਮਜੋਧ	برمجوده
ਪਰਮਠਾਕਰ	برمطهاكر
ਪਰਮਤੇਕ	برمتیك
ਪਰਮਦੀਪ	برمدیب
ਪਰਮਧਾਰਾਮ	برمدهارام
ਪਰਮਧਿਰ	برمدهیر
ਪਰਮਪਾਲ	برمبال
ਪਰਮਪ੍ਰੇਮ	برمبریم
ਪਰਮਬੋਧ	برمبوده
ਪਰਮਯੋਗ	برمیوج
ਪਰਮਰਂਗ	برمرنج
ਪਰਮਲੀਨ	برملین
ਪਰਮਸ਼ਾਂਤ	برمسانت
ਪਰਮਸਿਤਾਲ	برمسیتال
ਪਰਮਸੁਖ	برمسوكه
ਪਰਮਸੇਵਕ	برمسیوك
ਪਰਮਾਧਾਰ	برمادهار
ਪਰਮਾਰ੍ਥ	برمارته
ਪਰਮਿਂਦਰ	برمیندر
ਪਰਮੀਤ	برمیت
ਪਰਮ੍ਦਯਾ	برمدیا
ਪਰਸਂਜੀਤ	برسنجیت
ਪਰਸ਼ੋਤਮ	برسوتم
ਪਰਾਮਨੀਵਾਸ	برامنیواس
ਪਰੀਦਰ੍ਸ਼ਨ	بریدرسن
ਪਰ੍ਗਤ	برجت
ਪਰ੍ਵੀਨ੍ਦੇਰ	برویندیر
ਪਲਬੀਨਦੇਰ	بلبیندیر
ਪਲਵੀਨ੍ਦੇਰ੍ਪਾਲ	بلویندیربال
ਪਵਾਨਜੋਤ	بوانجوت
ਪਵਾਨਦੀਪ	بواندیب
ਪਵਾਨਪ੍ਰਿਤ	بوانبریت
ਪਵਾਨਵੀਰ	بوانویر
ਪਵੀਤ	بویت
ਪਾਰਂਗਤ	بارنجت
ਪੁਨੀਤ	بونیت
ਪੁਨੀਤਪਾਲ	بونیتبال
ਪੁਰਾਨਪ੍ਰੇਮ	بورانبریم
ਪੁਰਾਨ੍ਜੀਤ	بورانجیت
ਪੁਸ਼ਪ੍ਰਿਤ	بوسبریت
ਪੁਸ਼੍ਪਿਤਾ	بوسبیتا
ਪੂਰਨਜੀਤ	بورنجیت
ਪ੍ਰਗਿਤ	برجیت
ਪ੍ਰਜਨਾ	برجنا
ਪ੍ਰਣਿਤ	برنیت
ਪ੍ਰਨੀਤਾ	برنیتا
ਪ੍ਰਫੂਲਦੀਪ	بربهولدیب
ਪ੍ਰਭਕੀਰਤ	بربهكیرت
ਪ੍ਰਭਕੀਰ੍ਪਾਲ	بربهكیربال
ਪ੍ਰਭਗੀਤ	بربهجیت
ਪ੍ਰਭਚਰਣ	بربهتشرن
ਪ੍ਰਭਚੇਤਨ	بربهتشیتن
ਪ੍ਰਭਜਿਤ	بربهجیت
ਪ੍ਰਭਜੀਤ	بربهجیت
ਪ੍ਰਭਜੀਵਨ	بربهجیون
ਪ੍ਰਭਜੋਗ	بربهجوج
ਪ੍ਰਭਜੋਤੇ	بربهجوتي
ਪ੍ਰਭਜੋਧ	بربهجوده
ਪ੍ਰਭਤਿਰਥ	بربهتیرته
ਪ੍ਰਭਦਾਸ	بربهداس
ਪ੍ਰਭਧਿਯਨ	بربهدهیین
ਪ੍ਰਭਧਿਰਾਜ	بربهدهیراج
ਪ੍ਰਭਨਾਮ	بربهنام
ਪ੍ਰਭਨੂਰ	بربهنور
ਪ੍ਰਭਪਰ੍ਵਾਨ	بربهبروان
ਪ੍ਰਭਬੋਧ	بربهبوده
ਪ੍ਰਭਮਿਤ	بربهمیت
ਪ੍ਰਭਮੇਹਾਰ	بربهمیهار
ਪ੍ਰਭਲੀਨ	بربهلین
ਪ੍ਰਭਵਿਚਾਰ	بربهویتشار
ਪ੍ਰਭਸਂਗਤ	بربهسنجت
ਪ੍ਰਭਸਿਤਾਲ	بربهسیتال
ਪ੍ਰਭਾਤਕੀਰਣ	بربهاتكیرن
ਪ੍ਰਭ੍ਰਮਣ	بربهرمن
ਪ੍ਰਭ੍ਰਾਤਨ	بربهراتن
ਪ੍ਰਭ੍ਰੂਪ	بربهروب
ਪ੍ਰਸ਼ਾਰਨਬੀਰ	برسارنبیر
ਪ੍ਰਿਤਮੋਹਨ	بریتموهن
ਪ੍ਰਿਤੀਨ੍ਦੇਰ	بریتیندیر
ਪ੍ਰਿਤ੍ਵੀਰ	بریتویر
ਪ੍ਰੀਤਪਾਲ	بریتبال
ਪ੍ਰੀਤਮ੍ਹਾਰੀ	بریتمهاری
ਪ੍ਰੀਤਾਮਜਿਤ	بریتامجیت
ਪ੍ਰੀਥਾਮ੍ਦੀਪ	بریتهامدیب
ਪ੍ਰੀਥੀਪਾਲ	بریتهیبال
ਪ੍ਰੀਥ੍ਵੀਪਾਲ	بریتهویبال
ਪ੍ਰੇਮਜਿਤ	بریمجیت
ਪ੍ਰੇਮਤੇਕ	بریمتیك
ਪ੍ਰੇਮਪਾਲ	بریمبال
ਪ੍ਰੇਮਬਂਸ	بریمبنس
ਪ੍ਰੇਮਭਾਗਤ	بریمبهاجت
ਪ੍ਰੇਮਰਂਗ	بریمرنج
ਪ੍ਰੇਮਰਮਣ	بریمرمن
ਪ੍ਰੇਮਰਸ	بریمرس
ਪ੍ਰੇਮਲੀਨ	بریملین
ਪ੍ਰੇਮਵਾਂਤ	بریموانت
ਪ੍ਰੇਮਸੀਰੀ	بریمسیری
ਪ੍ਰੇਮਸੁਖ	بریمسوكه
ਪ੍ਰੇਮ੍ਵੀਰ	بریمویر
ਫਕੀਰ	بهكیر
ਫਤੇਹਕਾਰਾਮ	بهتیهكارام
ਫਤੇਹਪ੍ਰਿਤ	بهتیهبریت
ਫਤੇਹਬੀਰ	بهتیهبیر
ਫਤੇਹ੍ਵਂਤ	بهتیهونت
ਫਾਜਲ	بهاجل
ਫੁਲਵਂਤ	بهولونت
ਫੋਜੀਨਦੇਰ	بهوجیندیر
ਬਂਸਮਿਤ	بنسمیت
ਬਕ੍ਸ਼ੀ	بكسی
ਬਚਾਨਬੀਰ	بتشانبیر
ਬਚੀਨ੍ਤ	بتشینت
ਬਨੀਤ	بنیت
ਬਨੀਨਦੇਰ	بنیندیر
ਬਰਿਨ੍ਦ੍ਰ	بریندر
ਬਰੀਨ੍ਦੇਰ	بریندیر
ਬਲਤੇਜ	بلتیج
ਬਲਦੀਪ	بلدیب
ਬਲਦੇਵ	بلدیو
ਬਲਮੋਹਨ	بلموهن
ਬਲਰਾਜ	بلراج
ਬਲਵਿਂਦਰ	بلویندر
ਬਲੀਨਦੇਰ	بلیندیر
ਬਲੀਹਾਰ	بلیهار
ਬਲ੍ਵਿਨ੍ਦ੍ਰ	بلویندر
ਬਲ੍ਵੀਨ੍ਦੇਰ	بلویندیر
ਬਹਾਦਰ	بهادر
ਬਾਲਮਿਤ	بالمیت
ਬਿਸ਼ਨਪਾਲ	بیسنبال
ਬਿਸ੍ਮੀਤ	بیسمیت
ਬੀਨਦੇਰ	بیندیر
ਬੀਨਾ	بینا
ਬੀਬੀਨਾਨਾਕੀ	بیبیناناكی
ਬੀਮਾਂਲਜੋਤ	بیمانلجوت
ਬੀਰੀਨਦਾਰ	بیریندار
ਬੀਸਮਾਧ	بیسماده
ਬੀਸ਼੍ਮਿਤ	بیسمیت
ਬੁਜੀ	بوجی
ਬੁਧ੍ਪ੍ਰਿਤ	بودهبریت
ਬੁਧ੍ਰੂਪ	بودهروب
ਬੇਂਤ	بینت
ਬੇਨ੍ਨੀ	بیننی
ਬੇਬੇ	بیبي
ਬੈਰਾਗੀ	بایراجی
ਬ੍ਰਹਮਜੋਤ	برهمجوت
ਬ੍ਰਹਾਮਲੀਨ	برهاملین
ਬ੍ਰਹਾਮ੍ਜੀਤ	برهامجیت
ਬ੍ਰਹ੍ਮਲੀਨ	برهملین
ਬ੍ਰਹ੍ਮਵੀਰ	برهمویر
ਬ੍ਰਿਜੇਂਦਰ	بریجیندر
ਬ੍ਰੀਜੋਧ	بریجوده
ਭਗਤ	بهجت
ਭਗਵਾਨ	بهجوان
ਭਜਨਿਕ	بهجنیك
ਭਰਪੂਰ	بهربور
ਭਾਘਵੀਨ੍ਦੇਰ	بهاجهویندیر
ਭਾਜ੍ਨਾਮ	بهاجنام
ਭਾਜ੍ਨਿਤ	بهاجنیت
ਭਾਵਜਿਤ	بهاوجیت
ਭਾਵਜੀਨ੍ਦੇਰ	بهاوجیندیر
ਭਾਵਨਦੀਪ	بهاوندیب
ਭਾਵਨੀਤ	بهاونیت
ਭਾਵਪਾਲ	بهاوبال
ਭਾਵਪ੍ਰੇਮ	بهاوبریم
ਭਾਵਲੀਨ	بهاولین
ਭੀਨਦੇਰ੍ਪਾਲ	بهیندیربال
ਭੁਪੀਨ੍ਦੇਰ	بهوبیندیر
ਮਂਗਲਾ	منجلا
ਮਂਤੇਕ	منتیك
ਮਜਾਲ	مجال
ਮਣਿਪਾਲ	منیبال
ਮਧੁਪ੍ਰਿਤ	مدهوبریت
ਮਧੁਰਬੀਨ	مدهوربین
ਮਧੁਵਂਤ	مدهوونت
ਮਨਵਂਤ	منونت
ਮਰਦੁਲਾ	مردولا
ਮਸ੍ਤਪ੍ਰੇਮ	مستبریم
ਮਸ੍ਤਾਨ	مستان
ਮਸ੍ਤੁਕ	مستوك
ਮਸ੍ਤ੍ਵੀਰ	مستویر
ਮਹਨਬੀਰ	مهنبیر
ਮਹਾਜਿਤ	مهاجیت
ਮਹਾਨਗਿਯਨ	مهانجیین
ਮਹਾਨਗੀਤ	مهانجیت
ਮਹਾਨਗੁਨ	مهانجون
ਮਹਾਨਜਿਤ	مهانجیت
ਮਹਾਨਜੀਵਨ	مهانجیون
ਮਹਾਨਜੋਤ	مهانجوت
ਮਹਾਨਤੇਕ	مهانتیك
ਮਹਾਨਤ੍ਰੀਪਾਤ	مهانتریبات
ਮਹਾਨਦੀਪ	مهاندیب
ਮਹਾਨਪਾਲ	مهانبال
ਮਹਾਨਪ੍ਰੇਮ	مهانبریم
ਮਹਾਨਭਗਤ	مهانبهجت
ਮਹਿਨਦੇਰ੍ਪ੍ਰਿਤ	مهیندیربریت
ਮਹੀਨਗਾ	مهینجا
ਮਹੀਨਦੇਰ੍ਪਾਲ	مهیندیربال
ਮਹੇਕਪ੍ਰਿਤ	مهیكبریت
ਮਹੇਨਦੇਰ	مهیندیر
ਮਹੇਰਬਾਨੀ	مهیربانی
ਮਹੇਸ਼ੀਨਦੇਰ	مهیسیندیر
ਮਾਂਨਕਰਣ	ماننكرن
ਮਾਂਨਗਲ੍ਪ੍ਰਿਤ	ماننجلبریت
ਮਾਂਨਵਾਨ੍ਤ੍ਬੀਰ	ماننوانتبیر
ਮਾਂਨਸੀਰਤ	ماننسیرت
ਮਾਂਨਾਵੀਨਦੇਰ	مانناویندیر
ਮਾਂਨਾਸਪ੍ਰੇਮ	مانناسبریم
ਮਾਂਨੀਨਦੇਰ੍ਬੀਰ	ماننیندیربیر
ਮਾਂਨੋਹਾਰਜੋਤ	ماننوهارجوت
ਮਾਂਨੋਹਾਰਦੀਪ	ماننوهاردیب
ਮਾਂਨੋਹਾਰ੍ਜੀਤ	ماننوهارجیت
ਮਾਂਨੋਹਾਰ੍ਪਲ	ماننوهاربل
ਮਾਂਨ੍ਗਲ੍ਜੀਤ	ماننجلجیت
ਮਾਂਨ੍ਗਲ੍ਪ੍ਰੇਮ	ماننجلبریم
ਮਾਂਨ੍ਸ਼ਿਤਾਲ	ماننسیتال
ਮਾਦਨਬੀਰ	مادنبیر
ਮਾਦਾਨਕੀਰ੍ਪਾਲ	مادانكیربال
ਮਾਦਾਨਪਾਲ	مادانبال
ਮਾਨਤੇਜ	مانتیج
ਮਾਨਦੇਵ	ماندیو
ਮਾਨਪੁਲ	مانبول
ਮਾਨਬੀਰ	مانبیر
ਮਾਨਰਿਤ	مانریت
ਮਾਨਾਸਦੀਪ	ماناسدیب
ਮਾਨ੍ਕੀਰਣ	مانكیرن
ਮਾਨ੍ਗਲ੍ਜੋਤ	مانجلجوت
ਮਾਨ੍ਪ੍ਰੀਯਾ	مانبرییا
ਮਾਯ੍ਰਾਯ	مایرای
ਮਿਤ੍ਰਾ	میترا
ਮਿਤ੍ਰਾਜ	میتراج
ਮੀਰਾ	میرا
ਮੁਕੁਂਦਾ	موكوندا
ਮੁਕੁਨਦ੍ਪ੍ਰਿਤ	موكوندبریت
ਮੁਖ੍ਤਯਾਰ	موكهتیار
ਮੁਦ੍ਰਾ	مودرا
ਮੁਨਦੀਪ	موندیب
ਮੁਨਲੇਨੇ	مونلیني
ਮੇਸ਼	میس
ਮੇਹਰ	میهر
ਮੇਹਾਰਤੇਕ	میهارتیك
ਮੇਹਾਰਪਲ	میهاربل
ਮੇਹਾਰਪ੍ਰਿਤ	میهاربریت
ਮੇਹਾਰਭੂਪ	میهاربهوب
ਮੇਹਾਰਮਿਤ	میهارمیت
ਮੇਹੇਰ	میهیر
ਮੇਹੇਰਬਾਨੀ	میهیربانی
ਮੋਨੀਨ੍ਦੇਰ	مونیندیر
ਮੋਹਨਤੇਕ	موهنتیك
ਮੋਹਨਮਿਤ	موهنمیت
ਮੋਹਨਲੀਨ	موهنلین
ਮੋਹਨਵਂਤ	موهنونت
ਮੋਹਨਵੀਰ	موهنویر
ਮੋਹਿਨ੍ਦੇਰਪਾਲ	موهیندیربال
ਮੋਹੇਨਪਲ	موهینبل
ਮੋਹੇਨਪ੍ਰਿਤ	موهینبریت
ਯਕਿਨ	یكین
ਯਸ਼ਜੋਤ	یسجوت
ਯਸ਼ਨੂਰ	یسنور
ਯਸ਼ਪਾਲ	یسبال
ਯਸ਼ਵਂਤ	یسونت
ਯਸ਼੍ਦੀਪ	یسدیب
ਯਾਤੀਨਪਾਲ	یاتینبال
ਯਾਦਲੀਨ	یادلین
ਯਾਦਵੀਰ	یادویر
ਯਾਦ੍ਬੀਰ	یادبیر
ਯਾਸ੍ਮੀਨੇ	یاسمیني
ਯੁਵਰਾਨੀ	یوورانی
ਯੋਗੇਸ਼ਪਾਲ	یوجیسبال
ਰਂਗ ਰਮਨ	رنج رمن
ਰਂਗਜੋਤ	رنججوت
ਰਂਗਪ੍ਰਿਤ	رنجبریت
ਰਂਗਾਤਮ	رنجاتم
ਰਂਗੀਵਨ	رنجیون
ਰਂਜੀਤ	رنجیت
ਰਘੁਜਿਤ	رجهوجیت
ਰਘੁਬਂਸ	رجهوبنس
ਰਚਨਜਿਤ	رتشنجیت
ਰਚਨਜੋਤ	رتشنجوت
ਰਚ੍ਪੀਨਦੇਰ੍ਜਿਤ	رتشبیندیرجیت
ਰਜੀਨਦਾਰ	رجیندار
ਰਣਦੀਪ	رندیب
ਰਣਬੀਰ	رنبیر
ਰਤਨ੍ਕਾਰਾਮ	رتنكارام
ਰਤ੍ਤਾਨਜੋਤ	رتتانجوت
ਰਤ੍ਤਾਨਦੀਪ	رتتاندیب
ਰਨਗ੍ਰਤ੍ਤੀ	رنجرتتی
ਰਨਪ੍ਰਿਤ	رنبریت
ਰਪੀਨਦੇਰ	ربیندیر
ਰਮਚੇਤਨ	رمتشیتن
ਰਮਣੀਕ	رمنیك
ਰਮਨਜਿਤ	رمنجیت
ਰਮਨਦੀਪ	رمندیب
ਰਮਨਿਤ	رمنیت
ਰਮਨੀਵਾਸ	رمنیواس
ਰਮਲੀਨ	رملین
ਰਮਾਂਨਜੋਤ	رماننجوت
ਰਮਾਂਨਰੂਪ	رماننروب
ਰਮਾਂਨਸੁਖ	رماننسوكه
ਰਮਿਤ	رمیت
ਰਮਿਨਾਜੀਤ	رمیناجیت
ਰਮੀਨਦੇਰ੍ਜਿਤ	رمیندیرجیت
ਰਮੀਨਦੇਰ੍ਪਾਲ	رمیندیربال
ਰਮੀਨਦੇਰ੍ਪ੍ਰਿਤ	رمیندیربریت
ਰਮੀਨਦੇਰ੍ਬੀਰ	رمیندیربیر
ਰਮੇਸ਼ਪਲ	رمیسبل
ਰਮੇਸ਼ਮਿਤ	رمیسمیت
ਰਵਜੋਤ	روجوت
ਰਵਨੀਤ	رونیت
ਰਵਿਨ੍ਦਰ	رویندر
ਰਵਿਰਾਜ	رویراج
ਰਵੀਦੀਪ	رویدیب
ਰਵੀਨਦੇਰ੍ਦੀਪ	رویندیردیب
ਰਵੀਨਦੇਰ੍ਮਿਤ	رویندیرمیت
ਰਸਂਜਿਤ	رسنجیت
ਰਸਂਜੋਤ	رسنجوت
ਰਸਂਮਿਤ	رسنمیت
ਰਸਗੁਨ	رسجون
ਰਸਜੋਤ	رسجوت
ਰਸਧਾਰਮ	رسدهارم
ਰਸਨਂਦ	رسنند
ਰਸਪ੍ਰਿਤ	رسبریت
ਰਸਬੀਰ	رسبیر
ਰਸਭਾਗਤ	رسبهاجت
ਰਸਮ	رسم
ਰਸਮ੍ਰਿਤ	رسمریت
ਰਸਲੀਨ	رسلین
ਰਸਵਂਤ	رسونت
ਰਸ਼ਾਨ੍ਪ੍ਰਿਤ	رسانبریت
ਰਸੁਤ੍ਤਮ	رسوتتم
ਰਹੁਲਜੀਤ	رهولجیت
ਰਹੁਲਦੀਪ	رهولدیب
ਰਾਖਨਾਂ	راكهنان
ਰਾਖਬੀਰ	راكهبیر
ਰਾਜਕਿਰਣ	راجكیرن
ਰਾਜਦੀਪ	راجدیب
ਰਾਜਨਾਰੀਨ੍ਦ	راجناریند
ਰਾਜਪਰਾਮ	راجبرام
ਰਾਜਪਾਲ	راجبال
ਰਾਜਪ੍ਰਤਾਪ	راجبرتاب
ਰਾਜਮਂਦਰ	راجمندر
ਰਾਜਮਿਤ	راجمیت
ਰਾਜਸ਼ਰਣ	راجسرن
ਰਾਜਸੁਖ	راجسوكه
ਰਾਜਾਨਜਿਤ	راجانجیت
ਰਾਜਾਨਮਿਤ	راجانمیت
ਰਾਜਾਨ੍ਦੀਪ	راجاندیب
ਰਾਤਾਨਗੀਤ	راتانجیت
ਰਾਤਾਨਚੇਤਨ	راتانتشیتن
ਰਾਤਾਨਜੀਵਨ	راتانجیون
ਰਾਤਾਨਪ੍ਰਿਤ	راتانبریت
ਰਾਤਾਨਮਿਤ	راتانمیت
ਰਾਤਾਨਵਂਤ	راتانونت
ਰਾਤਾਨਾਤਮ	راتاناتم
ਰਾਮਦਾਸ	رامداس
ਰਾਮਪਾਲ	رامبال
ਰਾਮਰਂਗ	رامرنج
ਰਾਮਰਤ੍ਤਨ	رامرتتن
ਰਾਮਸੁਖ	رامسوكه
ਰਾਸਰਮਣ	راسرمن
ਰਾਸ਼੍ਪਲ	راسبل
ਰਾਸ਼੍ਮੀਨਦੇਰ	راسمیندیر
ਰਿਧਿਮਾ	ریدهیما
ਰੀਜਕ	ریجك
ਰੀਤੀਨਦੇਰ	ریتیندیر
ਰੀਪਨ੍ਜੋਤ	ریبنجوت
ਰੀਪੁਦਮ	ریبودم
ਰੂਂਗ / ਰਂਗ	رونج / رنج
ਰੂਪਦੀਪ	روبدیب
ਰੂਪਦੇਵ	روبدیو
ਰੂਪਵਂਤ	روبونت
ਰੇਗੇਨਦਰ	ریجیندر
ਰੋਸ਼ਨਦੀਪ	روسندیب
ਰੌਸ਼ਾਨਪ੍ਰੇਮ	راوسانبریم
ਰੌਸ਼ਾਨਬੀਰ	راوسانبیر
ਲਕ੍ਸ਼੍ਮੀ	لكسمی
ਲਖਪ੍ਰਿਤ	لكهبریت
ਲਖਮਿਤ	لكهمیت
ਲਖਰੂਪ	لكهروب
ਲਖਵੀਰ	لكهویر
ਲਵੇਨਿਤ	لوینیت
ਲਾਜਵਂਤ	لاجونت
ਲਾਵਪ੍ਰਿਤ	لاوبریت
ਲਾਵਿਨਦੀਪ	لاویندیب
ਲੀਵਗੀਆਨ	لیوجیآن
ਲੀਵਚਿਤ	لیوتشیت
ਲੀਵਚੇਤ	لیوتشیت
ਲੀਵਜੋਤ	لیوجوت
ਲੀਵਨਾਮ	لیونام
ਲੀਵਸ਼ਰਣ	لیوسرن
ਲੀਵਾਵਤਰ	لیواوتر
ਲੋਕਪਾਲ	لوكبال
ਲੋਕਪ੍ਰਿਤ	لوكبریت
ਲੋਕਰੂਪ	لوكروب
ਲੋਕ੍ਪ੍ਰੇਮ	لوكبریم
ਲੋਵਪ੍ਰੇਮ	لووبریم
ਲੋਵੇਦੀਪ	لوویدیب
ਵਰੀਨਦੇਰ੍ਪਾਲ	وریندیربال
ਵਰੁਨਜਿਤ	ورونجیت
ਵਰੁਨਦੀਪ	وروندیب
ਵਸਂਤਪ੍ਰਿਤ	وسنتبریت
ਵਸੁਂਧਰਾ	وسوندهرا
ਵਾਦਭਾਗ	وادبهاج
ਵਾਮਾਂਨਜੀਤ	واماننجیت
ਵਾਰੀਨਦੇਰ	واریندیر
ਵਾਸੀਮਬੀਰ	واسیمبیر
ਵਾਹੀਦਪ੍ਰਿਤ	واهیدبریت
ਵਾਹੇਗੁਰੁ	واهیجورو
ਵਿਕ੍ਰਮਜੀਤ	ویكرمجیت
ਵਿਕ੍ਰਮਜੋਤ	ویكرمجوت
ਵਿਚਾਰ੍ਚੇਤਨ	ویتشارتشیتن
ਵਿਚਾਰ੍ਦੀਪ	ویتشاردیب
ਵਿਚਾਰ੍ਲੀਨ	ویتشارلین
ਵਿਜਯਪ੍ਰਤਾਪ	ویجیبرتاب
ਵਿਜਯਪ੍ਰਿਤ	ویجیبریت
ਵਿਜੇਂਦਰ	ویجیندر
ਵਿਨਾਯਦੀਪ	وینایدیب
ਵਿਨਾਯਪੁਲ	وینایبول
ਵਿਨਾਯ੍ਬਿਰ	وینایبیر
ਵਿਮਾਂਲਜਿਤ	ویمانلجیت
ਵਿਮਾਂਲਜੋਤ	ویمانلجوت
ਵਿਮਾਂਲਪ੍ਰੇਮ	ویمانلبریم
ਵਿਰੀਨਦਾਰ ; ਵਿਰੀਨਦੇਰ	ویریندار ; ویریندیر
ਵਿਰੀਨਦੇਰ	ویریندیر
ਵਿਸਮਦ	ویسمد
ਵਿਸ਼ਾਲਦੀਪ	ویسالدیب
ਵਿਸ਼ਾਲਪ੍ਰਿਤ	ویسالبریت
ਵਿਸ਼੍ਵਰ੍ਪ੍ਰਿਤ	ویسوربریت
ਵਿਸ਼੍ਵਾਤਮ	ویسواتم
ਵਿਸਾਹ	ویساه
ਵੀਜਯਮਿਤ	ویجیمیت
ਵੀਰ	ویر
ਵੀਰ /ਵੀਰ	ویر /ویر
ਵੀਰਪਾਲ	ویربال
ਵੀਵੇਕ੍ਬੀਰ	ویویكبیر
ਵੀਸ੍ਰਮਣ	ویسرمن
ਵੇਰਾਜ	ویراج
ਵੈਭਵ	وایبهو
ਸਂਗਜਾਪ	سنججاب
ਸਂਗਤਪ੍ਰਿਤ	سنجتبریت
ਸਂਗਤਰੂਪ	سنجتروب
ਸਂਗਤ੍ਰਸ	سنجترس
ਸਂਗੀਤਾ	سنجیتا
ਸਂਗ੍ਰਾਮ	سنجرام
ਸਂਜੀਤ	سنجیت
ਸਂਜੋਗ	سنجوج
ਸਂਤਕੀਰੀਨ	سنتكیرین
ਸਂਤਪ੍ਰਕਾਸ਼	سنتبركاس
ਸਂਤਪ੍ਰੇਮ	سنتبریم
ਸਂਤਬੀਰ	سنتبیر
ਸਂਤੋਖਜੀਤ	سنتوكهجیت
ਸਂਤੋਖਜੋਤ	سنتوكهجوت
ਸਂਤੋਖਪ੍ਰਿਤ	سنتوكهبریت
ਸਂਤੋਖਬੀਰ	سنتوكهبیر
ਸਂਦੀਪ	سندیب
ਸਗਲਜੋਤ	سجلجوت
ਸਚਕਿਰਤ	ستشكیرت
ਸਚਜੋਗ	ستشجوج
ਸਚਪਾਲ	ستشبال
ਸਚਪ੍ਰਧਾਨ	ستشبردهان
ਸਚਭਾਗਤ	ستشبهاجت
ਸਚਮਾਨ	ستشمان
ਸਚਰੂਪ	ستشروب
ਸਚਵੀਰ	ستشویر
ਸਚਸੁਖ	ستشسوكه
ਸਚਸੇਵਕ	ستشسیوك
ਸਚਾਮ੍ਰਿਤ	ستشامریت
ਸਚ੍ਦੀਪ	ستشدیب
ਸਜੀਨਦੇਰ	سجیندیر
ਸਤਕਿਰਤ	ستكیرت
ਸਤਕੀਰਤ	ستكیرت
ਸਤਕੀਰ੍ਤਨ	ستكیرتن
ਸਤਗੁਨ	ستجون
ਸਤਗੁਰ	ستجور
ਸਤਜੋਤ	ستجوت
ਸਤਨਾਮ	ستنام
ਸਤਪਾਲ	ستبال
ਸਤਪ੍ਰਕਾਸ਼	ستبركاس
ਸਤਪ੍ਰਿਤ	ستبریت
ਸਤਪ੍ਰੇਮ	ستبریم
ਸਤਬਚਨ	ستبتشن
ਸਤਮਿਤ	ستمیت
ਸਤਰਜਿਤ	سترجیت
ਸਤਰਾਜ	ستراج
ਸਤਲੀਨ	ستلین
ਸਤਵਂਤ	ستونت
ਸਤਸਂਗਤ	ستسنجت
ਸਤਸਂਤੋਖ	ستسنتوكه
ਸਤਸਰਂਗ	ستسرنج
ਸਤਸੁਖ	ستسوكه
ਸਤੀਨਦੇਰ੍ਜਿਤ	ستیندیرجیت
ਸਤ੍ਯਜਿਤ	ستیجیت
ਸਤ੍ਯਪ੍ਰੇਮ	ستیبریم
ਸਥਿਨ੍ਦਰ	ستهیندر
ਸਦਜੀਵਨ	سدجیون
ਸਦਸੁਖ	سدسوكه
ਸਨਮੁਖ	سنموكه
ਸਨਾਨਤਨ	سنانتن
ਸਪਨਦੀਪ	سبندیب
ਸਪਾਹੀ	سباهی
ਸਬੂਰੀ	سبوری
ਸਭਾਜੀਤ	سبهاجیت
ਸਮਰਜੀਤ	سمرجیت
ਸਮਰਣ	سمرن
ਸਮਰਵੀਰ	سمرویر
ਸਮਰ੍ਥ	سمرته
ਸਮਾਂਰਬੀਰ	سمانربیر
ਸਮਾਂਰ੍ਜੋਤ	سمانرجوت
ਸਮਾਈ	سماإ
ਸਮੀਨਦੀਪ	سمیندیب
ਸਮੀਰ	سمیر
ਸਰਦਾਰ	سردار
ਸਰਨਦਾਯਲ	سرندایل
ਸਰਨਦੀਪ	سرندیب
ਸਰਨਾਗਤ	سرناجت
ਸਰਬਜੀਤ / ਸਰਬਜੀਤ	سربجیت / سربجیت
ਸਰਬਨੀਵਾਸ	سربنیواس
ਸਰਬਪ੍ਰਿਤ	سرببریت
ਸਰਬਸੁਖ	سربسوكه
ਸਰਬੁਤ੍ਤਮ	سربوتتم
ਸਰਬ੍ਗਿਆਨ	سربجیآن
ਸਰਬ੍ਜਿਤ	سربجیت
ਸਰਬ੍ਦਾਯਲ	سربدایل
ਸਰਬ੍ਦੀਪ	سربدیب
ਸਰਬ੍ਦੇਵ	سربدیو
ਸਰਬ੍ਧਾਰਾਮ	سربدهارام
ਸਰਲਜਿਤ	سرلجیت
ਸਰਲਬੀਰ	سرلبیر
ਸਰਾਬ੍ਰਜ	سرابرج
ਸਰੂਪ	سروب
ਸਰੂਰ	سرور
ਸਰ੍ਜਿਤ	سرجیت
ਸਰ੍ਮੀਨਦੇਰ	سرمیندیر
ਸਵਾਨਪ੍ਰਿਤ	سوانبریت
ਸਵਾਰਜਦੀਪ	سوارجدیب
ਸਵਾਰਜਬੀਰ	سوارجبیر
ਸਵਾਰਨਜੋਤ	سوارنجوت
ਸਵਾਰਨਪ੍ਰਿਤ	سوارنبریت
ਸਵੀਤੀਨਦੇਰ	سویتیندیر
ਸਵੀਤੋਜ	سویتوج
ਸਵੀਨਦੇਰ	سویندیر
ਸਹੀਲਮਿਤ	سهیلمیت
ਸ਼ਯ੍ਮ੍ਸੁਨ੍ਦਾਰ	سیمسوندار
ਸ਼ਰਨਪਾਲ	سرنبال
ਸ਼ਰਨਬੀਰ	سرنبیر
ਸ਼ਰਨ੍ਜੀਤ੍ਕੌਰ	سرنجیتكاور
ਸ਼ਾਂਤਚਿਤ	سانتتشیت
ਸ਼ਾਂਤਦੀਪ	سانتدیب
ਸ਼ਾਂਤਪ੍ਰਕਾਸ਼	سانتبركاس
ਸ਼ਾਂਤਪ੍ਰਿਤ	سانتبریت
ਸ਼ਾਂਤਬੀਰ	سانتبیر
ਸ਼ਾਂਤਲੀਨ	سانتلین
ਸ਼ਾਨਤ੍ਨੀਵਾਸ	سانتنیواس
ਸ਼ਾਬਦਚੇਤ	سابدتشیت
ਸ਼ਾਬਦਤੇਕ	سابدتیك
ਸ਼ਾਬਦ੍ਰਾਸ	سابدراس
ਸ਼ਾਬਾਦ੍ਦੀਪ	ساباددیب
ਸ਼ਾਲੀਨ	سالین
ਸ਼ਾਸ਼ੀਪ੍ਰਿਤ	ساسیبریت
ਸ਼ਿਵਚਰਣ	سیوتشرن
ਸ਼ਿਵ੍ਚਾਰਨ੍ਜੀਤ	سیوتشارنجیت
ਸ਼ੁਕਾਰਿਯਨ	سوكاریین
ਸ਼ੁਭਦੀਪ	سوبهدیب
ਸ਼ੂਰਵੀਰ	سورویر
ਸ਼ੇਰ	سیر
ਸ਼ੇਰਪੁਲ	سیربول
ਸ਼ੇਰਬਹਾਦੁਰ	سیربهادور
ਸ਼ੇਹ੍ਬਾਝ	سیهباجه
ਸਾਕਰਥ	ساكرته
ਸਾਖ	ساكه
ਸਾਗਰ	ساجر
ਸਾਜ	ساج
ਸਾਤਪੁਲ	ساتبول
ਸਾਧਨਾਹ	سادهناه
ਸਾਧਿਕਾ	سادهیكا
ਸਾਬਰ	سابر
ਸਾਰ	سار
ਸਿਂਦਾ	سیندا
ਸਿਓਪਰਿਤ	سیاوبریت
ਸਿਤਾਲਜੀਤ	سیتالجیت
ਸਿਤਾਲਜੋਤ	سیتالجوت
ਸਿਮਰਨ	سیمرن
ਸੀਖਲ	سیكهل
ਸੀਮਾਂਰ੍ਜਿਤ	سیمانرجیت
ਸੀਮਾਂਰ੍ਨਾਮ	سیمانرنام
ਸੀਮਾਂਰ੍ਪ੍ਰਿਤ	سیمانربریت
ਸੀਮਾਂਰ੍ਲੀਨ	سیمانرلین
ਸੀਮ੍ਰਤ	سیمرت
ਸੀਮ੍ਰਨਪਾਲ	سیمرنبال
ਸੀਮ੍ਰਨਪ੍ਰਿਤ	سیمرنبریت
ਸੀਮ੍ਰਨ੍ਕੌਰ	سیمرنكاور
ਸੀਮ੍ਰਨ੍ਜੀਤ	سیمرنجیت
ਸੀਮ੍ਰੀਤਾ	سیمریتا
ਸੀਰਤ	سیرت
ਸੀਰੀਪ੍ਰੀਤਮ	سیریبریتم
ਸੀਰੀਵੇਦ੍ਯਾ	سیریویدیا
ਸੀਰੀਸੀਮ੍ਰਣ	سیریسیمرن
ਸੀਰੀਸੇਵਾ	سیریسیوا
ਸੁਖਚੈਨ	سوكهتشاین
ਸੁਖਜੀਵਨ	سوكهجیون
ਸੁਖਜੋਤ	سوكهجوت
ਸੁਖਜੋਧ	سوكهجوده
ਸੁਖਦਾਯਲ	سوكهدایل
ਸੁਖਦੀਪ	سوكهدیب
ਸੁਖਦੇਵ	سوكهدیو
ਸੁਖਬੀਰ	سوكهبیر
ਸੁਖਮਾਂ	سوكهمان
ਸੁਖਰੂਪ	سوكهروب
ਸੁਖਸਿਤਾਲ	سوكهسیتال
ਸੁਖਸੀਮ੍ਰਣ	سوكهسیمرن
ਸੁਖਾਨਂਦ	سوكهانند
ਸੁਖਿਤ	سوكهیت
ਸੁਖੀਨ	سوكهین
ਸੁਖੀਨ੍ਦੇਰ	سوكهیندیر
ਸੁਖ੍ਚਾਰਨ੍ਜੀਤ	سوكهتشارنجیت
ਸੁਖ੍ਜਿਤ	سوكهجیت
ਸੁਚਦੀਪ	سوتشدیب
ਸੁਚਦੇਵ	سوتشدیو
ਸੁਚਮ	سوتشم
ਸੁਜਨਰੂਪ	سوجنروب
ਸੁਜਨ੍ਬੀਰ	سوجنبیر
ਸੁਜ੍ਜਨ	سوججن
ਸੁਧਬੁਧ	سودهبوده
ਸੁਧਸੁਰਤ	سودهسورت
ਸੁਭਪ੍ਰਿਤ	سوبهبریت
ਸੁਹੇਜਦੀਪ	سوهیجدیب
ਸੇਵਾਕਪ੍ਰਿਤ	سیواكبریت
ਸੇਵਾਕਪ੍ਰੇਮ	سیواكبریم
ਸੇਵਾਕਰਣ	سیواكرن
ਸੇਵਾਪ੍ਰੀਤ	سیوابریت
ਸੇਹਜ	سیهج
ਸੇਹੇਜਬੀਰ	سیهیجبیر
ਸੈਲੇਸ਼ਦੀਪ	سایلیسدیب
ਸੈਹਜ	سایهج
ਸੈਹਾਜਨੀਵਾਸ	سایهاجنیواس
ਸੈਹਾਜਲੀਨ	سایهاجلین
ਸੈਹਾਜਾਧਾਰ	سایهاجادهار
ਸੋਚੀ	سوتشی
ਸੋਨਹਨ	سونهن
ਸੋਭਾਵਂਤ	سوبهاونت
ਸੋਹੀਨਦੇਰ	سوهیندیر
ਸੋਹੁਨ	سوهون
ਸ੍ਵਰ੍ਨ	سورن
ਹਕਾਮਪ੍ਰਿਤ	هكامبریت
ਹਨ੍ਸ੍ਪਾਲ	هنسبال
ਹਰਕਾਨ੍ਵਾਲ	هركانوال
ਹਰਕੀਰਣ	هركیرن
ਹਰਗੀਤ	هرجیت
ਹਰਗੁਰ੍ਮਿਤ (ਮਿਤ )	هرجورمیت (میت )
ਹਰਗੋਬੀਨ੍ਦ	هرجوبیند
ਹਰਚਰਣ	هرتشرن
ਹਰਜਪ	هرجب
ਹਰਜੀ	هرجی
ਹਰਜੀਤ	هرجیت
ਹਰਜੀਨ੍ਦੇਰ	هرجیندیر
ਹਰਜੀਵ	هرجیو
ਹਰਜੁਗਤ	هرجوجت
ਹਰਜੋਗ	هرجوج
ਹਰਜੋਧ	هرجوده
ਹਰਜ੍ਯੋਤ	هرجیوت
ਹਰਤਿਰਥ	هرتیرته
ਹਰਤੇਜ੍ਪਾਲ	هرتیجبال
ਹਰਦਯਾਲ	هردیال
ਹਰਦਾਸ	هرداس
ਹਰਦਿਪਾ	هردیبا
ਹਰਦੀਪ	هردیب
ਹਰਧਨ	هردهن
ਹਰਨਾਮ	هرنام
ਹਰਨਾਰਾਯਣ	هرناراین
ਹਰਨਿਤ	هرنیت
ਹਰਨੀਰ੍ਮਲ	هرنیرمل
ਹਰਨੀਹਲ	هرنیهل
ਹਰਪਰ੍ਸਨ੍ਨ	هربرسنن
ਹਰਪਾਲ	هربال
ਹਰਪ੍ਰੇਮ੍ਜੀਤ	هربریمجیت
ਹਰਬਿਂਦਰ	هربیندر
ਹਰਬਿਰ	هربیر
ਹਰਭਗਤ	هربهجت
ਹਰਮਨਾਦ	هرمناد
ਹਰਮਾਂਨ੍ਦੇਰ	هرمانندیر
ਹਰਮੀਤ	هرمیت
ਹਰਮੀਲਨ	هرمیلن
ਹਰਮੂਰਤ	هرمورت
ਹਰਰਾਈ	هرراإ
ਹਰਰੂਪ	هرروب
ਹਰਵਂਤ	هرونت
ਹਰਵਿਨ	هروین
ਹਰਸ਼ਰਣ	هرسرن
ਹਰਸਿਤਾਲ	هرسیتال
ਹਰਸੀਮ੍ਰਣ	هرسیمرن
ਹਰਸੀਮ੍ਰਨ੍ਜੋਤ	هرسیمرنجوت
ਹਰਸੀਮ੍ਰਿਤ	هرسیمریت
ਹਰਸੁਖ	هرسوكه
ਹਰਾਨੂਪ	هرانوب
ਹਰਾਮ੍ਰੀਤ	هرامریت
ਹਰਿਕੀਰ੍ਤਨ	هریكیرتن
ਹਰਿਦਰ੍ਸ਼ਨ	هریدرسن
ਹਰਿਨਾਰਾਯਣ	هریناراین
ਹਰਿਪ੍ਰੀਤ	هریبریت
ਹਰੀਅਮ੍ਰਿਤ	هریامریت
ਹਰੀਸਰੂਪ	هریسروب
ਹਰੀਸੀਮਾਂਰਣ	هریسیمانرن
ਹਰ੍ਕਾਰਾਨ੍ਜੀਤ	هركارانجیت
ਹਰ੍ਕੀਰਨ੍ਜੀਤ	هركیرنجیت
ਹਰ੍ਕੀਰਪਾਲ	هركیربال
ਹਰ੍ਜਸ	هرجس
ਹਰ੍ਤੇਇਜ	هرتیإج
ਹਰ੍ਨੀਝ	هرنیجه
ਹਰ੍ਬਂਸ	هربنس
ਹਰ੍ਮਾਂਨਜਿਤ	هرماننجیت
ਹਰ੍ਮਾਂਨਪਾਲ	هرماننبال
ਹਰ੍ਮੀਨ੍ਦੇਰ	هرمیندیر
ਹਰ੍ਮੇਂਦ੍ਰ	هرمیندر
ਹਰ੍ਸ਼ਰ੍ਧਾ	هرسردها
ਹਰ੍ਸ਼ਵਰ੍ਧਨ	هرسوردهن
ਹਰ੍ਸ਼ਾਗੁਨ	هرساجون
ਹਰ੍ਸਿਰਤ	هرسیرت
ਹਸਨ	هسن
ਹਾਰਭਾਗ	هاربهاج
ਹਿਤੀਨਦੇਰ	هیتیندیر
ਹਿਤੇਨਦੇਰ	هیتیندیر
ਹਿਮ੍ਮਤ	هیممت
ਹਿਰੀਸ਼	هیریس
ਹੁਅਲੀਨਾ	هوالینا
ਹੁਕੁਮਪਰਿਤ	هوكومبریت
ਹੂਜਓਏ	هوجاوي
ਹੇਤ	هیت
ਹੇਤਬੀਰ	هیتبیر
ਹੇਮੀਨਦੇਰ	هیمیندیر
ਹੇਯ੍ਮਾਂਨ੍ਪ੍ਰਿਤ	هییماننبریت
ਹੇਰਹੋ	هیرهو
