# Territory names from CLDR
அஷன்ஷியன் தீவு	aṣaṉṣiyaṉ tīvu
அன்டோரா	aṉṭōrā
ஐக்கிய அரபு எமிரேட்ஸ்	aikkiya arapu emirēṭs
ஆப்கானிஸ்தான்	āpkāṉistāṉ
ஆண்டிகுவா மற்றும் பார்புடா	āṇṭikuvā maṟṟum pārpuṭā
அங்குய்லா	aṅkuylā
அல்பேனியா	alpēṉiyā
அர்மேனியா	armēṉiyā
அங்கோலா	aṅkōlā
அண்டார்டிகா	aṇṭārṭikā
அர்ஜென்டினா	arjeṉṭiṉā
அமெரிக்க சமோவா	amerikka camōvā
ஆஸ்திரியா	āstiriyā
ஆஸ்திரேலியா	āstirēliyā
அரூபா	arūpā
ஆலந்து தீவுகள்	ālantu tīvukaḷ
அசர்பைஜான்	acarpaijāṉ
போஸ்னியா &amp; ஹெர்ஸகோவினா	pōsṉiyā &amp; hersakōviṉā
பார்படோஸ்	pārpaṭōs
பங்களாதேஷ்	paṅkaḷātēṣ
பெல்ஜியம்	peljiyam
புர்கினா ஃபாஸோ	purkiṉā ḥpāsō
பல்கேரியா	palkēriyā
பஹ்ரைன்	pahraiṉ
புருண்டி	puruṇṭi
பெனின்	peṉiṉ
செயின்ட் பார்தேலெமி	ceyiṉṭ pārtēlemi
பெர்முடா	permuṭā
புரூனேய்	purūṉēy
பொலிவியா	poliviyā
கரீபியன் நெதர்லாந்து	karīpiyaṉ netarlāntu
பிரேசில்	pirēcil
பஹாமாஸ்	pahāmās
பூடான்	pūṭāṉ
பொவேட் தீவுகள்	povēṭ tīvukaḷ
போட்ஸ்வானா	pōṭsvāṉā
பெலாரூஸ்	pelārūs
பெலிஸ்	pelis
கனடா	kaṉaṭā
கோகோஸ் (கீலிங்) தீவுகள்	kōkōs (kīliṅ) tīvukaḷ
காங்கோ - கின்ஷாசா	kāṅkō - kiṉṣācā
காங்கோ (டிஆர்சி)	kāṅkō (ṭi'ārci)
மத்திய ஆப்ரிக்கக் குடியரசு	mattiya āprikkak kuṭiyaracu
காங்கோ - ப்ராஸாவில்லே	kāṅkō - prāsāvillē
காங்கோ (குடியரசு)	kāṅkō (kuṭiyaracu)
ஸ்விட்சர்லாந்து	sviṭcarlāntu
கோட் தி’வாயர்	kōṭ ti’vāyar
ஐவரி கோஸ்ட்	aivari kōsṭ
குக் தீவுகள்	kuk tīvukaḷ
சிலி	cili
கேமரூன்	kēmarūṉ
சீனா	cīṉā
கொலம்பியா	kolampiyā
கிலிப்பர்டன் தீவு	kilipparṭaṉ tīvu
கோஸ்டாரிகா	kōsṭārikā
கியூபா	kiyūpā
கேப் வெர்டே	kēp verṭē
குராகவ்	kurākav
கிறிஸ்துமஸ் தீவு	kiṟistumas tīvu
சைப்ரஸ்	caipras
செக் குடியரசு	cek kuṭiyaracu
ஜெர்மனி	jermaṉi
டியகோ கார்ஷியா	ṭiyakō kārṣiyā
ஜிபௌட்டி	jipauṭṭi
டென்மார்க்	ṭeṉmārk
டொமினிகா	ṭomiṉikā
டொமினிகன் குடியரசு	ṭomiṉikaṉ kuṭiyaracu
அல்ஜீரியா	aljīriyā
சியூடா &amp; மெலில்லா	ciyūṭā &amp; melillā
ஈக்வடார்	īkvaṭār
எஸ்டோனியா	esṭōṉiyā
எகிப்து	ekiptu
மேற்கு சஹாரா	mēṟku cahārā
எரிட்ரியா	eriṭriyā
ஸ்பெயின்	speyiṉ
எதியோப்பியா	etiyōppiyā
ஐரோப்பிய யூனியன்	airōppiya yūṉiyaṉ
பின்லாந்து	piṉlāntu
ஃபிஜி	ḥpiji
ஃபாக்லாந்து தீவுகள்	ḥpāklāntu tīvukaḷ
ஃபாக்லாந்து தீவுகள் (இஸ்லாஸ் மால்வினஸ்)	ḥpāklāntu tīvukaḷ (islās mālviṉas)
மைக்ரோனேஷியா	maikrōṉēṣiyā
ஃபாரோ தீவுகள்	ḥpārō tīvukaḷ
பிரான்ஸ்	pirāṉs
கேபான்	kēpāṉ
ஐக்கிய பேரரசு	aikkiya pēraracu
யூகே	yūkē
கிரனெடா	kiraṉeṭā
ஜார்ஜியா	jārjiyā
பிரெஞ்சு கயானா	pireñcu kayāṉā
கெர்ன்சி	kerṉci
கானா	kāṉā
ஜிப்ரால்டர்	jiprālṭar
கிரீன்லாந்து	kirīṉlāntu
காம்பியா	kāmpiyā
கினியா	kiṉiyā
க்வாதேலோப்	kvātēlōp
ஈக்வடோரியல் கினியா	īkvaṭōriyal kiṉiyā
கிரீஸ்	kirīs
தென் ஜியார்ஜியா மற்றும் தென் சான்ட்விச் தீவுகள்	teṉ jiyārjiyā maṟṟum teṉ cāṉṭvic tīvukaḷ
கவுதமாலா	kavutamālā
குவாம்	kuvām
கினியா-பிஸ்ஸாவ்	kiṉiyā-pis'sāv
கயானா	kayāṉā
ஹாங்காங் எஸ்ஏஆர் சீனா	hāṅkāṅ esē'ār cīṉā
ஹாங்காங்	hāṅkāṅ
ஹேர்ட் மற்றும் மெக்டொனால்டு தீவுகள்	hērṭ maṟṟum mekṭoṉālṭu tīvukaḷ
ஹோண்டூராஸ்	hōṇṭūrās
குரேஷியா	kurēṣiyā
ஹைட்டி	haiṭṭi
ஹங்கேரி	haṅkēri
கேனரி தீவுகள்	kēṉari tīvukaḷ
இந்தோனேசியா	intōṉēciyā
அயர்லாந்து	ayarlāntu
இஸ்ரேல்	isrēl
ஐல் ஆஃப் மேன்	ail āḥp mēṉ
இந்தியா	intiyā
பிரிட்டிஷ் இந்தியப் பெருங்கடல் பிரதேசம்	piriṭṭiṣ intiyap peruṅkaṭal piratēcam
ஈராக்	īrāk
ஈரான்	īrāṉ
ஐஸ்லாந்து	aislāntu
இத்தாலி	ittāli
ஜெர்சி	jerci
ஜமைகா	jamaikā
ஜோர்டான்	jōrṭāṉ
ஜப்பான்	jappāṉ
கென்யா	keṉyā
கிர்கிஸ்தான்	kirkistāṉ
கம்போடியா	kampōṭiyā
கிரிபடி	kiripaṭi
கோமரோஸ்	kōmarōs
செயின்ட் கிட்ஸ் &amp; நெவிஸ்	ceyiṉṭ kiṭs &amp; nevis
வட கொரியா	vaṭa koriyā
தென் கொரியா	teṉ koriyā
குவைத்	kuvait
கெய்மென் தீவுகள்	keymeṉ tīvukaḷ
கஸகஸ்தான்	kasakastāṉ
லாவோஸ்	lāvōs
லெபனான்	lepaṉāṉ
செயின்ட் லூசியா	ceyiṉṭ lūciyā
லிச்செண்ஸ்டெய்ன்	licceṇsṭeyṉ
இலங்கை	ilaṅkai
லைபீரியா	laipīriyā
லெசோதோ	lecōtō
லிதுவேனியா	lituvēṉiyā
லக்ஸ்சம்பர்க்	lakscampark
லாட்வியா	lāṭviyā
லிபியா	lipiyā
மொராக்கோ	morākkō
மொனாக்கோ	moṉākkō
மால்டோவா	mālṭōvā
மான்டேனெக்ரோ	māṉṭēṉekrō
செயின்ட் மார்ட்டீன்	ceyiṉṭ mārṭṭīṉ
மடகாஸ்கர்	maṭakāskar
மார்ஷல் தீவுகள்	mārṣal tīvukaḷ
மாசிடோனியா	māciṭōṉiyā
மாசிடோனியா (ஃபைரோம்)	māciṭōṉiyā (ḥpairōm)
மாலி	māli
மியான்மார் (பர்மா)	miyāṉmār (parmā)
மங்கோலியா	maṅkōliyā
மகாவ் எஸ்ஏஆர் சீனா	makāv esē'ār cīṉā
மகாவ்	makāv
வடக்கு மரியானா தீவுகள்	vaṭakku mariyāṉā tīvukaḷ
மார்டினிக்	mārṭiṉik
மௌரிடானியா	mauriṭāṉiyā
மாண்ட்செராட்	māṇṭcerāṭ
மால்டா	mālṭā
மொரிசியஸ்	moriciyas
மாலத்தீவு	mālattīvu
மலாவி	malāvi
மெக்சிகோ	mekcikō
மலேசியா	malēciyā
மொசாம்பிக்	mocāmpik
நமீபியா	namīpiyā
நியூ கேலிடோனியா	niyū kēliṭōṉiyā
நைஜர்	naijar
நார்ஃபோக் தீவுகள்	nārḥpōk tīvukaḷ
நைஜீரியா	naijīriyā
நிகரகுவா	nikarakuvā
நெதர்லாந்து	netarlāntu
நார்வே	nārvē
நேபாளம்	nēpāḷam
நௌரு	nauru
நியூ	niyū
நியூசிலாந்து	niyūcilāntu
ஓமன்	ōmaṉ
பனாமா	paṉāmā
பெரு	peru
பிரெஞ்சு பாலினேஷியா	pireñcu pāliṉēṣiyā
பப்புவா நியூ கினியா	pappuvā niyū kiṉiyā
பிலிப்பைன்ஸ்	pilippaiṉs
பாகிஸ்தான்	pākistāṉ
போலந்து	pōlantu
செயின்ட் பியர் &amp; மிக்வேலான்	ceyiṉṭ piyar &amp; mikvēlāṉ
பிட்கெய்ர்ன் தீவுகள்	piṭkeyrṉ tīvukaḷ
பியூர்டோ ரிகோ	piyūrṭō rikō
பாலஸ்தீனிய பிரதேசங்கள்	pālastīṉiya piratēcaṅkaḷ
பாலஸ்தீனம்	pālastīṉam
போர்ச்சுக்கல்	pōrccukkal
பாலோ	pālō
பராகுவே	parākuvē
கத்தார்	kattār
வெளிப்புற ஓஷியானியா	veḷippuṟa ōṣiyāṉiyā
ரீயூனியன்	rīyūṉiyaṉ
ருமேனியா	rumēṉiyā
செர்பியா	cerpiyā
ரஷ்யா	raṣyā
ருவான்டா	ruvāṉṭā
சவூதி அரேபியா	cavūti arēpiyā
சாலமன் தீவுகள்	cālamaṉ tīvukaḷ
சீஷெல்ஸ்	cīṣels
சூடான்	cūṭāṉ
ஸ்வீடன்	svīṭaṉ
சிங்கப்பூர்	ciṅkappūr
செயின்ட் ஹெலெனா	ceyiṉṭ heleṉā
ஸ்லோவேனியா	slōvēṉiyā
ஸ்வல்பார்டு &amp; ஜான் மேயன்	svalpārṭu &amp; jāṉ mēyaṉ
ஸ்லோவாகியா	slōvākiyā
சியாரா லியோன்	ciyārā liyōṉ
சான் மரினோ	cāṉ mariṉō
செனெகல்	ceṉekal
சோமாலியா	cōmāliyā
சுரினாம்	curiṉām
தெற்கு சூடான்	teṟku cūṭāṉ
சாவ் தோம் &amp; ப்ரின்சிபி	cāv tōm &amp; priṉcipi
எல் சால்வடார்	el cālvaṭār
சின்ட் மார்டென்	ciṉṭ mārṭeṉ
சிரியா	ciriyā
ஸ்வாஸிலாந்து	svāsilāntu
டிரிஸ்டன் டா குன்ஹா	ṭirisṭaṉ ṭā kuṉhā
டர்க்ஸ் &amp; கைகோஸ் தீவுகள்	ṭarks &amp; kaikōs tīvukaḷ
சாட்	cāṭ
பிரெஞ்சு தெற்கு பிரதேசங்கள்	pireñcu teṟku piratēcaṅkaḷ
டோகோ	ṭōkō
தாய்லாந்து	tāylāntu
தாஜிகிஸ்தான்	tājikistāṉ
டோகேலோ	ṭōkēlō
தைமூர்-லெஸ்தே	taimūr-lestē
கிழக்கு தைமூர்	kiḻakku taimūr
துர்க்மெனிஸ்தான்	turkmeṉistāṉ
டுனிசியா	ṭuṉiciyā
டோங்கா	ṭōṅkā
துருக்கி	turukki
ட்ரினிடாட் &amp; டொபாகோ	ṭriṉiṭāṭ &amp; ṭopākō
துவாலூ	tuvālū
தைவான்	taivāṉ
தான்சானியா	tāṉcāṉiyā
உக்ரைன்	ukraiṉ
உகாண்டா	ukāṇṭā
அமெரிக்கா	amerikkā
யூஎஸ்	yū'es
உருகுவே	urukuvē
உஸ்பெகிஸ்தான்	uspekistāṉ
வாடிகன் நகரம்	vāṭikaṉ nakaram
செயின்ட் வின்சென்ட் &amp; கிரெனடைன்ஸ்	ceyiṉṭ viṉceṉṭ &amp; kireṉaṭaiṉs
வெனிசுலா	veṉiculā
பிரிட்டீஷ் கன்னித் தீவுகள்	piriṭṭīṣ kaṉṉit tīvukaḷ
வியட்நாம்	viyaṭnām
வனுவாட்டு	vaṉuvāṭṭu
வாலிஸ் மற்றும் ஃபுடுனா	vālis maṟṟum ḥpuṭuṉā
சமோவா	camōvā
கொசோவோ	kocōvō
ஏமன்	ēmaṉ
மயோட்	mayōṭ
தென் ஆப்பிரிக்கா	teṉ āppirikkā
ஜாம்பியா	jāmpiyā
ஜிம்பாப்வே	jimpāpvē
அறியப்படாத பிரதேசம்	aṟiyappaṭāta piratēcam
